Archaea_Aenigmarchaeota_Aenigmarchaeota_Incertae_Sedis_Unknown_Order_Unknown_Family_Candidatus_Aenigmarchaeum	Archaea
Archaea_Aenigmarchaeota_Deep_Sea_Euryarchaeotic_Group_DSEG_	Archaea
Archaea_Aigarchaeota_Aigarchaeota_Incertae_Sedis_Unknown_Order_Unknown_Family_Candidatus_Caldiarchaeum	Archaea
Archaea_Aigarchaeota_Terrestrial_Hot_Spring_Gp_THSCG_	Archaea
Archaea_Ancient_Archaeal_Group_AAG_	Archaea
Archaea_Crenarchaeota_Thermoprotei	Archaea
Archaea_Diapherotrites_Diapherotrites_Incertae_Sedis_Unknown_Order_Unknown_Family_Candidatus_Iainarchaeum	Archaea
Archaea_Euryarchaeota_Archaeoglobi_Archaeoglobales_Archaeoglobaceae	Archaea
Archaea_Euryarchaeota_Halobacteria_Halobacteriales_Halobacteriaceae	Archaea
Archaea_Euryarchaeota_Methanobacteria_Methanobacteriales	Archaea
Archaea_Euryarchaeota_Methanococci_Methanococcales	Archaea
Archaea_Euryarchaeota_Methanomicrobia	Archaea
Archaea_Euryarchaeota_Methanopyri_Methanopyrales_Methanopyraceae_Methanopyrus	Archaea
Archaea_Euryarchaeota_Thermococci_Thermococcales_Thermococcaceae	Archaea
Archaea_Euryarchaeota_Thermoplasmata	Archaea
Archaea_Korarchaeota_Korarchaeota_Incertae_Sedis_Unknown_Order_Unknown_Family_Candidatus_Korarchaeum	Archaea
Archaea_Marine_Hydrothermal_Vent_Group_1_MHVG-1_	Archaea
Archaea_Marine_Hydrothermal_Vent_Group_2_MHVG-2_	Archaea
Archaea_Marine_Hydrothermal_Vent_Group_MHVG_	Archaea
Archaea_Miscellaneous_Crenarchaeotic_Group	Archaea
Archaea_Miscellaneous_Euryarchaeotic_Group_MEG_	Archaea
Archaea_Nanoarchaeota_Nanoarchaeota_Incertae_Sedis_Unknown_Order_Unknown_Family_Nanoarchaeum	Archaea
Archaea_Nanohaloarchaeota	Archaea
Archaea_Parvarchaeota_Parvarchaeota_Incertae_Sedis_Unknown_Order_Unknown_Family_Candidatus_Micrarchaeum	Archaea
Archaea_pCIRA-13	Archaea
Archaea_SM1K20	Archaea
Archaea_Thaumarchaeota_AB64A-17	Archaea
Archaea_Thaumarchaeota_AK31	Archaea
Archaea_Thaumarchaeota_AK56	Archaea
Archaea_Thaumarchaeota_AK59	Archaea
Archaea_Thaumarchaeota_AK8	Archaea
Archaea_Thaumarchaeota_ArcC-u-cD06	Archaea
Archaea_Thaumarchaeota_AS48	Archaea
Archaea_Thaumarchaeota_D-F10	Archaea
Archaea_Thaumarchaeota_F9P122000-Arc-2-E02	Archaea
Archaea_Thaumarchaeota_FS243A-60	Archaea
Archaea_Thaumarchaeota_Group_C3	Archaea
Archaea_Thaumarchaeota_HDBA-SITS389	Archaea
Archaea_Thaumarchaeota_HDBA-SITS413	Archaea
Archaea_Thaumarchaeota_Marine_Benthic_Group_A	Archaea
Archaea_Thaumarchaeota_Marine_Benthic_Group_B	Archaea
Archaea_Thaumarchaeota_Marine_Group_I	Archaea
Archaea_Thaumarchaeota_OPPD003	Archaea
Archaea_Thaumarchaeota_Papm3A43	Archaea
Archaea_Thaumarchaeota_pMC2A209	Archaea
Archaea_Thaumarchaeota_pSL12	Archaea
Archaea_Thaumarchaeota_Sc-EA05	Archaea
Archaea_Thaumarchaeota_SIFC624	Archaea
Archaea_Thaumarchaeota_SIGW1085	Archaea
Archaea_Thaumarchaeota_SIGW396	Archaea
Archaea_Thaumarchaeota_SIGW621	Archaea
Archaea_Thaumarchaeota_Soil_Crenarchaeotic_Group_SCG__Unknown_Order_Unknown_Family_Candidatus_Nitrososphaera	Archaea
Archaea_Thaumarchaeota_South_African_Gold_Mine_Gp_1_SAGMCG-1__Unknown_Order_Unknown_Family_Candidatus_Nitrosotalea	Archaea
Archaea_Thaumarchaeota_terrestrial_group	Archaea
Archaea_Thaumarchaeota_Thaumarchaeota_Incertae_Sedis_Unknown_Order_Unknown_Family_Candidatus_Nitrosocaldus	Archaea
Archaea_Thaumarchaeota_TOTO-A6-15	Archaea
Archaea_Thaumarchaeota_Z273FA48	Archaea
Archaea_TVG8AR30	Archaea
Archaea_Woesearchaeota__DHVEG-6_	Archaea
Bacteria_Acetothermia_Unknown_Class_Unknown_Order_Unknown_Family_Candidatus_Acetothermus	Bacteria;Others
Bacteria_Acidobacteria_Acidobacteria_11B-2	Bacteria;Others
Bacteria_Acidobacteria_Acidobacteria_Acidobacteriales_Acidobacteriaceae__Subgroup_1_	Bacteria;Others
Bacteria_Acidobacteria_Acidobacteria_AT-s3-28	Bacteria;Others
Bacteria_Acidobacteria_Acidobacteria_d142	Bacteria;Others
Bacteria_Acidobacteria_Acidobacteria_FFCH5909	Bacteria;Others
Bacteria_Acidobacteria_Acidobacteria_GBS-L1-B05	Bacteria;Others
Bacteria_Acidobacteria_Acidobacteria_Subgroup_11	Bacteria;Others
Bacteria_Acidobacteria_Acidobacteria_Subgroup_12	Bacteria;Others
Bacteria_Acidobacteria_Acidobacteria_Subgroup_13	Bacteria;Others
Bacteria_Acidobacteria_Acidobacteria_Subgroup_15	Bacteria;Others
Bacteria_Acidobacteria_Acidobacteria_Subgroup_17	Bacteria;Others
Bacteria_Acidobacteria_Acidobacteria_Subgroup_18	Bacteria;Others
Bacteria_Acidobacteria_Acidobacteria_Subgroup_19	Bacteria;Others
Bacteria_Acidobacteria_Acidobacteria_Subgroup_2	Bacteria;Others
Bacteria_Acidobacteria_Acidobacteria_Subgroup_20	Bacteria;Others
Bacteria_Acidobacteria_Acidobacteria_Subgroup_21	Bacteria;Others
Bacteria_Acidobacteria_Acidobacteria_Subgroup_25	Bacteria;Others
Bacteria_Acidobacteria_Acidobacteria_Subgroup_3	Bacteria;Others
Bacteria_Acidobacteria_Acidobacteria_Subgroup_4_11-24	Bacteria;Others
Bacteria_Acidobacteria_Acidobacteria_Subgroup_4_DS-100	Bacteria;Others
Bacteria_Acidobacteria_Acidobacteria_Subgroup_4_Elev-16S-573	Bacteria;Others
Bacteria_Acidobacteria_Acidobacteria_Subgroup_4_RB41	Bacteria;Others
Bacteria_Acidobacteria_Acidobacteria_Subgroup_4_uncultured	Bacteria;Others
Bacteria_Acidobacteria_Acidobacteria_Subgroup_4_Unknown_Family	Bacteria;Others
Bacteria_Acidobacteria_Acidobacteria_Subgroup_5	Bacteria;Others
Bacteria_Acidobacteria_Acidobacteria_Subgroup_6	Bacteria;Others
Bacteria_Acidobacteria_Acidobacteria_Subgroup_9	Bacteria;Others
Bacteria_Acidobacteria_Holophagae_Acanthopleuribacterales_Acanthopleuribacteraceae_Acanthopleuribacter	Bacteria;Others
Bacteria_Acidobacteria_Holophagae_Acanthopleuribacterales_Acanthopleuribacteraceae_Thermotomaculum	Bacteria;Others
Bacteria_Acidobacteria_Holophagae_B276-D12	Bacteria;Others
Bacteria_Acidobacteria_Holophagae_BP-U1C-1g10	Bacteria;Others
Bacteria_Acidobacteria_Holophagae_Elev-16S-816	Bacteria;Others
Bacteria_Acidobacteria_Holophagae_Holophagae_Incertae_Sedis_Unknown_Family_Thermoanaerobaculum	Bacteria;Others
Bacteria_Acidobacteria_Holophagae_Holophagales_Holophagaceae_Geothrix	Bacteria;Others
Bacteria_Acidobacteria_Holophagae_Holophagales_Holophagaceae_Holophaga	Bacteria;Others
Bacteria_Acidobacteria_Holophagae_Holophagales_Holophagaceae_marine_group	Bacteria;Others
Bacteria_Acidobacteria_Holophagae_Holophagales_Holophagaceae_uncultured	Bacteria;Others
Bacteria_Acidobacteria_Holophagae_Subgroup_10	Bacteria;Others
Bacteria_Acidobacteria_Holophagae_Subgroup_23	Bacteria;Others
Bacteria_Acidobacteria_Holophagae_Subgroup_7	Bacteria;Others
Bacteria_Acidobacteria_Holophagae_TPD-58	Bacteria;Others
Bacteria_Acidobacteria_Subgroup_22	Bacteria;Others
Bacteria_Acidobacteria_Subgroup_26	Bacteria;Others
Bacteria_Actinobacteria_Acidimicrobiia_Acidimicrobiales_Acidimicrobiaceae	Bacteria;Actinobacteria
Bacteria_Actinobacteria_Acidimicrobiia_Acidimicrobiales_Acidimicrobiales_Incertae_Sedis	Bacteria;Actinobacteria
Bacteria_Actinobacteria_Acidimicrobiia_Acidimicrobiales_Iamiaceae_Iamia	Bacteria;Actinobacteria
Bacteria_Actinobacteria_Acidimicrobiia_Acidimicrobiales_OM1_clade_Candidatus_Actinomarina	Bacteria;Actinobacteria
Bacteria_Actinobacteria_Acidimicrobiia_Acidimicrobiales_Sva0996_marine_group	Bacteria;Actinobacteria
Bacteria_Actinobacteria_Acidimicrobiia_Acidimicrobiales_uncultured	Bacteria;Actinobacteria
Bacteria_Actinobacteria_Actinobacteria_Actinomycetales_Actinomycetaceae	Bacteria;Actinobacteria
Bacteria_Actinobacteria_Actinobacteria_Actinopolysporales_Actinopolysporaceae	Bacteria;Actinobacteria
Bacteria_Actinobacteria_Actinobacteria_Bifidobacteriales_Bifidobacteriaceae	Bacteria;Actinobacteria
Bacteria_Actinobacteria_Actinobacteria_Catenulisporales	Bacteria;Actinobacteria
Bacteria_Actinobacteria_Actinobacteria_Corynebacteriales	Bacteria;Actinobacteria
Bacteria_Actinobacteria_Actinobacteria_Elev-16S-976	Bacteria;Actinobacteria
Bacteria_Actinobacteria_Actinobacteria_Frankiales	Bacteria;Actinobacteria
Bacteria_Actinobacteria_Actinobacteria_Glycomycetales_Glycomycetaceae	Bacteria;Actinobacteria
Bacteria_Actinobacteria_Actinobacteria_Kineosporiales_Kineosporiaceae	Bacteria;Actinobacteria
Bacteria_Actinobacteria_Actinobacteria_Micrococcales	Bacteria;Actinobacteria
Bacteria_Actinobacteria_Actinobacteria_Micromonosporales_Micromonosporaceae	Bacteria;Actinobacteria
Bacteria_Actinobacteria_Actinobacteria_PeM15	Bacteria;Actinobacteria
Bacteria_Actinobacteria_Actinobacteria_Propionibacteriales	Bacteria;Actinobacteria
Bacteria_Actinobacteria_Actinobacteria_Pseudonocardiales_Pseudonocardiaceae	Bacteria;Actinobacteria
Bacteria_Actinobacteria_Actinobacteria_SIFF498-N9D4	Bacteria;Actinobacteria
Bacteria_Actinobacteria_Actinobacteria_Streptomycetales_Streptomycetaceae	Bacteria;Actinobacteria
Bacteria_Actinobacteria_Actinobacteria_Streptosporangiales	Bacteria;Actinobacteria
Bacteria_Actinobacteria_Actinobacteria_uncultured	Bacteria;Actinobacteria
Bacteria_Actinobacteria_Coriobacteriia_Coriobacteriales_Coriobacteriaceae_Adlercreutzia	Bacteria;Actinobacteria
Bacteria_Actinobacteria_Coriobacteriia_Coriobacteriales_Coriobacteriaceae_Asaccharobacter	Bacteria;Actinobacteria
Bacteria_Actinobacteria_Coriobacteriia_Coriobacteriales_Coriobacteriaceae_Atopobium	Bacteria;Actinobacteria
Bacteria_Actinobacteria_Coriobacteriia_Coriobacteriales_Coriobacteriaceae_Collinsella	Bacteria;Actinobacteria
Bacteria_Actinobacteria_Coriobacteriia_Coriobacteriales_Coriobacteriaceae_Coriobacteriaceae_UCG-002	Bacteria;Actinobacteria
Bacteria_Actinobacteria_Coriobacteriia_Coriobacteriales_Coriobacteriaceae_Coriobacteriaceae_UCG-003	Bacteria;Actinobacteria
Bacteria_Actinobacteria_Coriobacteriia_Coriobacteriales_Coriobacteriaceae_Coriobacterium	Bacteria;Actinobacteria
Bacteria_Actinobacteria_Coriobacteriia_Coriobacteriales_Coriobacteriaceae_Cryptobacterium	Bacteria;Actinobacteria
Bacteria_Actinobacteria_Coriobacteriia_Coriobacteriales_Coriobacteriaceae_Denitrobacterium	Bacteria;Actinobacteria
Bacteria_Actinobacteria_Coriobacteriia_Coriobacteriales_Coriobacteriaceae_Eggerthella	Bacteria;Actinobacteria
Bacteria_Actinobacteria_Coriobacteriia_Coriobacteriales_Coriobacteriaceae_Enorma	Bacteria;Actinobacteria
Bacteria_Actinobacteria_Coriobacteriia_Coriobacteriales_Coriobacteriaceae_Enterorhabdus	Bacteria;Actinobacteria
Bacteria_Actinobacteria_Coriobacteriia_Coriobacteriales_Coriobacteriaceae_Gordonibacter	Bacteria;Actinobacteria
Bacteria_Actinobacteria_Coriobacteriia_Coriobacteriales_Coriobacteriaceae_Olsenella	Bacteria;Actinobacteria
Bacteria_Actinobacteria_Coriobacteriia_Coriobacteriales_Coriobacteriaceae_Paraeggerthella	Bacteria;Actinobacteria
Bacteria_Actinobacteria_Coriobacteriia_Coriobacteriales_Coriobacteriaceae_Parvibacter	Bacteria;Actinobacteria
Bacteria_Actinobacteria_Coriobacteriia_Coriobacteriales_Coriobacteriaceae_Senegalimassilia	Bacteria;Actinobacteria
Bacteria_Actinobacteria_Coriobacteriia_Coriobacteriales_Coriobacteriaceae_Slackia	Bacteria;Actinobacteria
Bacteria_Actinobacteria_Coriobacteriia_Coriobacteriales_Coriobacteriaceae_uncultured	Bacteria;Actinobacteria
Bacteria_Actinobacteria_FFCH16263	Bacteria;Actinobacteria
Bacteria_Actinobacteria_KIST-JJY010	Bacteria;Actinobacteria
Bacteria_Actinobacteria_MB-A2-108	Bacteria;Actinobacteria
Bacteria_Actinobacteria_Nitriliruptoria	Bacteria;Actinobacteria
Bacteria_Actinobacteria_OPB41	Bacteria;Actinobacteria
Bacteria_Actinobacteria_Rubrobacteria_Rubrobacterales_Rubrobacteriaceae_Rubrobacter	Bacteria;Actinobacteria
Bacteria_Actinobacteria_TakashiAC-B11	Bacteria;Actinobacteria
Bacteria_Actinobacteria_Thermoleophilia_Gaiellales	Bacteria;Actinobacteria
Bacteria_Actinobacteria_Thermoleophilia_Solirubrobacterales	Bacteria;Actinobacteria
Bacteria_Actinobacteria_Thermoleophilia_Thermophilales_Thermoleophilaceae_Thermoleophilum	Bacteria;Actinobacteria
Bacteria_Aerophobetes	Bacteria;Others
Bacteria_Aminicenantes	Bacteria;Others
Bacteria_aquifer1	Bacteria;Others
Bacteria_aquifer2	Bacteria;Others
Bacteria_Aquificae_Aquificae_Aquificales_Aquificaceae	Bacteria;Others
Bacteria_Aquificae_Aquificae_Aquificales_Aquificales_Incertae_Sedis_Thermosulfidibacter	Bacteria;Others
Bacteria_Aquificae_Aquificae_Aquificales_Desulfurobacteriaceae	Bacteria;Others
Bacteria_Aquificae_Aquificae_Aquificales_Hydrogenothermaceae	Bacteria;Others
Bacteria_Armatimonadetes_Armatimonadia_Armatimonadales_Armatimonadaceae_Armatimonas	Bacteria;Others
Bacteria_Armatimonadetes_Chthonomonadetes_Chthonomonadales_Chthonomonadaceae_Chthonomonas	Bacteria;Others
Bacteria_Atribacteria_Atribacteria_Incertae_Sedis_Unknown_Order_Unknown_Family_Candidatus_Caldatribacterium	Bacteria;Others
Bacteria_Bacteroidetes_Bacteroidetes_BD2-2	Bacteria;Bacteroidetes
Bacteria_Bacteroidetes_Bacteroidetes_vadinHA17	Bacteria;Bacteroidetes
Bacteria_Bacteroidetes_Bacteroidetes_VC2.1_Bac22	Bacteria;Bacteroidetes
Bacteria_Bacteroidetes_Bacteroidia_Bacteroidales_009E01-B-SD-P15	Bacteria;Bacteroidetes
Bacteria_Bacteroidetes_Bacteroidia_Bacteroidales_3M1PL1-52_termite_group	Bacteria;Bacteroidetes
Bacteria_Bacteroidetes_Bacteroidia_Bacteroidales_Bacteroidaceae_Bacteroides	Bacteria;Bacteroidetes
Bacteria_Bacteroidetes_Bacteroidia_Bacteroidales_Bacteroidales_BS11_gut_group	Bacteria;Bacteroidetes
Bacteria_Bacteroidetes_Bacteroidia_Bacteroidales_Bacteroidales_Incertae_Sedis_Phocaeicola	Bacteria;Bacteroidetes
Bacteria_Bacteroidetes_Bacteroidia_Bacteroidales_Bacteroidales_RF16_group	Bacteria;Bacteroidetes
Bacteria_Bacteroidetes_Bacteroidia_Bacteroidales_Bacteroidales_S24-7_group	Bacteria;Bacteroidetes
Bacteria_Bacteroidetes_Bacteroidia_Bacteroidales_Bacteroidales_UCG-001	Bacteria;Bacteroidetes
Bacteria_Bacteroidetes_Bacteroidia_Bacteroidales_CAP-aah99b04	Bacteria;Bacteroidetes
Bacteria_Bacteroidetes_Bacteroidia_Bacteroidales_COB_P4-1_termite_group	Bacteria;Bacteroidetes
Bacteria_Bacteroidetes_Bacteroidia_Bacteroidales_CR-115	Bacteria;Bacteroidetes
Bacteria_Bacteroidetes_Bacteroidia_Bacteroidales_FTLpost3	Bacteria;Bacteroidetes
Bacteria_Bacteroidetes_Bacteroidia_Bacteroidales_gir-aah93h0	Bacteria;Bacteroidetes
Bacteria_Bacteroidetes_Bacteroidia_Bacteroidales_GZKB124	Bacteria;Bacteroidetes
Bacteria_Bacteroidetes_Bacteroidia_Bacteroidales_LKC2.127-25	Bacteria;Bacteroidetes
Bacteria_Bacteroidetes_Bacteroidia_Bacteroidales_M2PB4-65_termite_group	Bacteria;Bacteroidetes
Bacteria_Bacteroidetes_Bacteroidia_Bacteroidales_Marinilabiaceae_Alkaliflexus	Bacteria;Bacteroidetes
Bacteria_Bacteroidetes_Bacteroidia_Bacteroidales_Marinilabiaceae_Alkalitalea	Bacteria;Bacteroidetes
Bacteria_Bacteroidetes_Bacteroidia_Bacteroidales_Marinilabiaceae_Anaerophaga	Bacteria;Bacteroidetes
Bacteria_Bacteroidetes_Bacteroidia_Bacteroidales_Marinilabiaceae_Carboxylicivirga	Bacteria;Bacteroidetes
Bacteria_Bacteroidetes_Bacteroidia_Bacteroidales_Marinilabiaceae_Geofilum	Bacteria;Bacteroidetes
Bacteria_Bacteroidetes_Bacteroidia_Bacteroidales_Marinilabiaceae_Mangroviflexus	Bacteria;Bacteroidetes
Bacteria_Bacteroidetes_Bacteroidia_Bacteroidales_Marinilabiaceae_Marinifilum	Bacteria;Bacteroidetes
Bacteria_Bacteroidetes_Bacteroidia_Bacteroidales_Marinilabiaceae_Marinilabilia	Bacteria;Bacteroidetes
Bacteria_Bacteroidetes_Bacteroidia_Bacteroidales_Marinilabiaceae_Natronoflexus	Bacteria;Bacteroidetes
Bacteria_Bacteroidetes_Bacteroidia_Bacteroidales_Marinilabiaceae_Ruminofilibacter	Bacteria;Bacteroidetes
Bacteria_Bacteroidetes_Bacteroidia_Bacteroidales_Marinilabiaceae_Saccharicrinis	Bacteria;Bacteroidetes
Bacteria_Bacteroidetes_Bacteroidia_Bacteroidales_Marinilabiaceae_Thermophagus	Bacteria;Bacteroidetes
Bacteria_Bacteroidetes_Bacteroidia_Bacteroidales_Marinilabiaceae_uncultured	Bacteria;Bacteroidetes
Bacteria_Bacteroidetes_Bacteroidia_Bacteroidales_MgMjR-022	Bacteria;Bacteroidetes
Bacteria_Bacteroidetes_Bacteroidia_Bacteroidales_ML635J-40_aquatic_group	Bacteria;Bacteroidetes
Bacteria_Bacteroidetes_Bacteroidia_Bacteroidales_p-2534-18B5_gut_group	Bacteria;Bacteroidetes
Bacteria_Bacteroidetes_Bacteroidia_Bacteroidales_PeH15	Bacteria;Bacteroidetes
Bacteria_Bacteroidetes_Bacteroidia_Bacteroidales_PL-11B8_wastewater-sludge_group	Bacteria;Bacteroidetes
Bacteria_Bacteroidetes_Bacteroidia_Bacteroidales_Porphyromonadaceae_Barnesiella	Bacteria;Bacteroidetes
Bacteria_Bacteroidetes_Bacteroidia_Bacteroidales_Porphyromonadaceae_Butyricimonas	Bacteria;Bacteroidetes
Bacteria_Bacteroidetes_Bacteroidia_Bacteroidales_Porphyromonadaceae_Candidatus_Armantifilum	Bacteria;Bacteroidetes
Bacteria_Bacteroidetes_Bacteroidia_Bacteroidales_Porphyromonadaceae_Candidatus_Azobacteroides	Bacteria;Bacteroidetes
Bacteria_Bacteroidetes_Bacteroidia_Bacteroidales_Porphyromonadaceae_Candidatus_Symbiothrix	Bacteria;Bacteroidetes
Bacteria_Bacteroidetes_Bacteroidia_Bacteroidales_Porphyromonadaceae_Coprobacter	Bacteria;Bacteroidetes
Bacteria_Bacteroidetes_Bacteroidia_Bacteroidales_Porphyromonadaceae_Dysgonomonas	Bacteria;Bacteroidetes
Bacteria_Bacteroidetes_Bacteroidia_Bacteroidales_Porphyromonadaceae_Macellibacteroides	Bacteria;Bacteroidetes
Bacteria_Bacteroidetes_Bacteroidia_Bacteroidales_Porphyromonadaceae_Microbacter	Bacteria;Bacteroidetes
Bacteria_Bacteroidetes_Bacteroidia_Bacteroidales_Porphyromonadaceae_Odoribacter	Bacteria;Bacteroidetes
Bacteria_Bacteroidetes_Bacteroidia_Bacteroidales_Porphyromonadaceae_Paludibacter	Bacteria;Bacteroidetes
Bacteria_Bacteroidetes_Bacteroidia_Bacteroidales_Porphyromonadaceae_Parabacteroides	Bacteria;Bacteroidetes
Bacteria_Bacteroidetes_Bacteroidia_Bacteroidales_Porphyromonadaceae_Petrimonas	Bacteria;Bacteroidetes
Bacteria_Bacteroidetes_Bacteroidia_Bacteroidales_Porphyromonadaceae_Porphyromonas	Bacteria;Bacteroidetes
Bacteria_Bacteroidetes_Bacteroidia_Bacteroidales_Porphyromonadaceae_Proteiniphilum	Bacteria;Bacteroidetes
Bacteria_Bacteroidetes_Bacteroidia_Bacteroidales_Porphyromonadaceae_Tannerella	Bacteria;Bacteroidetes
Bacteria_Bacteroidetes_Bacteroidia_Bacteroidales_Porphyromonadaceae_uncultured	Bacteria;Bacteroidetes
Bacteria_Bacteroidetes_Bacteroidia_Bacteroidales_Prevotellaceae_Alloprevotella	Bacteria;Bacteroidetes
Bacteria_Bacteroidetes_Bacteroidia_Bacteroidales_Prevotellaceae_Paraprevotella	Bacteria;Bacteroidetes
Bacteria_Bacteroidetes_Bacteroidia_Bacteroidales_Prevotellaceae_Prevotella	Bacteria;Bacteroidetes
Bacteria_Bacteroidetes_Bacteroidia_Bacteroidales_Prevotellaceae_Prevotella_1	Bacteria;Bacteroidetes
Bacteria_Bacteroidetes_Bacteroidia_Bacteroidales_Prevotellaceae_Prevotella_2	Bacteria;Bacteroidetes
Bacteria_Bacteroidetes_Bacteroidia_Bacteroidales_Prevotellaceae_Prevotella_6	Bacteria;Bacteroidetes
Bacteria_Bacteroidetes_Bacteroidia_Bacteroidales_Prevotellaceae_Prevotella_7	Bacteria;Bacteroidetes
Bacteria_Bacteroidetes_Bacteroidia_Bacteroidales_Prevotellaceae_Prevotella_9	Bacteria;Bacteroidetes
Bacteria_Bacteroidetes_Bacteroidia_Bacteroidales_Prevotellaceae_Prevotellaceae_Ga6A1_group	Bacteria;Bacteroidetes
Bacteria_Bacteroidetes_Bacteroidia_Bacteroidales_Prevotellaceae_Prevotellaceae_NK3B31_group	Bacteria;Bacteroidetes
Bacteria_Bacteroidetes_Bacteroidia_Bacteroidales_Prevotellaceae_Prevotellaceae_UCG-001	Bacteria;Bacteroidetes
Bacteria_Bacteroidetes_Bacteroidia_Bacteroidales_Prevotellaceae_Prevotellaceae_UCG-003	Bacteria;Bacteroidetes
Bacteria_Bacteroidetes_Bacteroidia_Bacteroidales_Prevotellaceae_Prevotellaceae_UCG-004	Bacteria;Bacteroidetes
Bacteria_Bacteroidetes_Bacteroidia_Bacteroidales_Prevotellaceae_Prevotellaceae_YAB2003_group	Bacteria;Bacteroidetes
Bacteria_Bacteroidetes_Bacteroidia_Bacteroidales_Prevotellaceae_uncultured	Bacteria;Bacteroidetes
Bacteria_Bacteroidetes_Bacteroidia_Bacteroidales_RH-aaj90h05	Bacteria;Bacteroidetes
Bacteria_Bacteroidetes_Bacteroidia_Bacteroidales_Rikenellaceae_Alistipes	Bacteria;Bacteroidetes
Bacteria_Bacteroidetes_Bacteroidia_Bacteroidales_Rikenellaceae_BCf9-17_termite_group	Bacteria;Bacteroidetes
Bacteria_Bacteroidetes_Bacteroidia_Bacteroidales_Rikenellaceae_Blvii28_wastewater-sludge_group	Bacteria;Bacteroidetes
Bacteria_Bacteroidetes_Bacteroidia_Bacteroidales_Rikenellaceae_dgA-11_gut_group	Bacteria;Bacteroidetes
Bacteria_Bacteroidetes_Bacteroidia_Bacteroidales_Rikenellaceae_hoa5-07d05_gut_group	Bacteria;Bacteroidetes
Bacteria_Bacteroidetes_Bacteroidia_Bacteroidales_Rikenellaceae_M2PB4-61_termite_group	Bacteria;Bacteroidetes
Bacteria_Bacteroidetes_Bacteroidia_Bacteroidales_Rikenellaceae_Mucinivorans	Bacteria;Bacteroidetes
Bacteria_Bacteroidetes_Bacteroidia_Bacteroidales_Rikenellaceae_Rikenella	Bacteria;Bacteroidetes
Bacteria_Bacteroidetes_Bacteroidia_Bacteroidales_Rikenellaceae_Rikenellaceae_RC9_gut_group	Bacteria;Bacteroidetes
Bacteria_Bacteroidetes_Bacteroidia_Bacteroidales_Rikenellaceae_Rs-D38_termite_group	Bacteria;Bacteroidetes
Bacteria_Bacteroidetes_Bacteroidia_Bacteroidales_Rikenellaceae_S50_wastewater-sludge_group	Bacteria;Bacteroidetes
Bacteria_Bacteroidetes_Bacteroidia_Bacteroidales_Rikenellaceae_SP3-e08	Bacteria;Bacteroidetes
Bacteria_Bacteroidetes_Bacteroidia_Bacteroidales_Rikenellaceae_U29-B03	Bacteria;Bacteroidetes
Bacteria_Bacteroidetes_Bacteroidia_Bacteroidales_Rikenellaceae_uncultured	Bacteria;Bacteroidetes
Bacteria_Bacteroidetes_Bacteroidia_Bacteroidales_Rikenellaceae_vadinBC27_wastewater-sludge_group	Bacteria;Bacteroidetes
Bacteria_Bacteroidetes_Bacteroidia_Bacteroidales_Rs-E47_termite_group	Bacteria;Bacteroidetes
Bacteria_Bacteroidetes_Bacteroidia_Bacteroidales_uncultured	Bacteria;Bacteroidetes
Bacteria_Bacteroidetes_Bacteroidia_Bacteroidales_vadinHA21	Bacteria;Bacteroidetes
Bacteria_Bacteroidetes_Bacteroidia_Bacteroidia_Incertae_Sedis_Draconibacteriaceae_Draconibacterium	Bacteria;Bacteroidetes
Bacteria_Bacteroidetes_Bacteroidia_Bacteroidia_Incertae_Sedis_Draconibacteriaceae_Mariniphaga	Bacteria;Bacteroidetes
Bacteria_Bacteroidetes_Bacteroidia_Bacteroidia_Incertae_Sedis_Draconibacteriaceae_Tangfeifania	Bacteria;Bacteroidetes
Bacteria_Bacteroidetes_Bacteroidia_Bacteroidia_Incertae_Sedis_Draconibacteriaceae_uncultured	Bacteria;Bacteroidetes
Bacteria_Bacteroidetes_Bacteroidia_Bacteroidia_Incertae_Sedis_Prolixibacteraceae_Prolixibacter	Bacteria;Bacteroidetes
Bacteria_Bacteroidetes_BSV13	Bacteria;Bacteroidetes
Bacteria_Bacteroidetes_Cytophagia_Cytophagales_Cyclobacteriaceae	Bacteria;Bacteroidetes
Bacteria_Bacteroidetes_Cytophagia_Cytophagales_Cytophagaceae_Adhaeribacter	Bacteria;Bacteroidetes
Bacteria_Bacteroidetes_Cytophagia_Cytophagales_Cytophagaceae_Arcicella	Bacteria;Bacteroidetes
Bacteria_Bacteroidetes_Cytophagia_Cytophagales_Cytophagaceae_Chryseolinea	Bacteria;Bacteroidetes
Bacteria_Bacteroidetes_Cytophagia_Cytophagales_Cytophagaceae_Cytophaga	Bacteria;Bacteroidetes
Bacteria_Bacteroidetes_Cytophagia_Cytophagales_Cytophagaceae_Dyadobacter	Bacteria;Bacteroidetes
Bacteria_Bacteroidetes_Cytophagia_Cytophagales_Cytophagaceae_Emticicia	Bacteria;Bacteroidetes
Bacteria_Bacteroidetes_Cytophagia_Cytophagales_Cytophagaceae_Fibrella	Bacteria;Bacteroidetes
Bacteria_Bacteroidetes_Cytophagia_Cytophagales_Cytophagaceae_Fibrisoma	Bacteria;Bacteroidetes
Bacteria_Bacteroidetes_Cytophagia_Cytophagales_Cytophagaceae_Flectobacillus	Bacteria;Bacteroidetes
Bacteria_Bacteroidetes_Cytophagia_Cytophagales_Cytophagaceae_Flexibacter	Bacteria;Bacteroidetes
Bacteria_Bacteroidetes_Cytophagia_Cytophagales_Cytophagaceae_Fluviimonas	Bacteria;Bacteroidetes
Bacteria_Bacteroidetes_Cytophagia_Cytophagales_Cytophagaceae_Hymenobacter	Bacteria;Bacteroidetes
Bacteria_Bacteroidetes_Cytophagia_Cytophagales_Cytophagaceae_Larkinella	Bacteria;Bacteroidetes
Bacteria_Bacteroidetes_Cytophagia_Cytophagales_Cytophagaceae_Leadbetterella	Bacteria;Bacteroidetes
Bacteria_Bacteroidetes_Cytophagia_Cytophagales_Cytophagaceae_Mangrovibacterium	Bacteria;Bacteroidetes
Bacteria_Bacteroidetes_Cytophagia_Cytophagales_Cytophagaceae_Meniscus	Bacteria;Bacteroidetes
Bacteria_Bacteroidetes_Cytophagia_Cytophagales_Cytophagaceae_Microscilla	Bacteria;Bacteroidetes
Bacteria_Bacteroidetes_Cytophagia_Cytophagales_Cytophagaceae_Mooreia	Bacteria;Bacteroidetes
Bacteria_Bacteroidetes_Cytophagia_Cytophagales_Cytophagaceae_Nibrella	Bacteria;Bacteroidetes
Bacteria_Bacteroidetes_Cytophagia_Cytophagales_Cytophagaceae_Nibribacter	Bacteria;Bacteroidetes
Bacteria_Bacteroidetes_Cytophagia_Cytophagales_Cytophagaceae_Ohtaekwangia	Bacteria;Bacteroidetes
Bacteria_Bacteroidetes_Cytophagia_Cytophagales_Cytophagaceae_Persicitalea	Bacteria;Bacteroidetes
Bacteria_Bacteroidetes_Cytophagia_Cytophagales_Cytophagaceae_Pontibacter	Bacteria;Bacteroidetes
Bacteria_Bacteroidetes_Cytophagia_Cytophagales_Cytophagaceae_Pseudarcicella	Bacteria;Bacteroidetes
Bacteria_Bacteroidetes_Cytophagia_Cytophagales_Cytophagaceae_Rhodocytophaga	Bacteria;Bacteroidetes
Bacteria_Bacteroidetes_Cytophagia_Cytophagales_Cytophagaceae_Rudanella	Bacteria;Bacteroidetes
Bacteria_Bacteroidetes_Cytophagia_Cytophagales_Cytophagaceae_Rufibacter	Bacteria;Bacteroidetes
Bacteria_Bacteroidetes_Cytophagia_Cytophagales_Cytophagaceae_Runella	Bacteria;Bacteroidetes
Bacteria_Bacteroidetes_Cytophagia_Cytophagales_Cytophagaceae_Siphonobacter	Bacteria;Bacteroidetes
Bacteria_Bacteroidetes_Cytophagia_Cytophagales_Cytophagaceae_Spirosoma	Bacteria;Bacteroidetes
Bacteria_Bacteroidetes_Cytophagia_Cytophagales_Cytophagaceae_Sporocytophaga	Bacteria;Bacteroidetes
Bacteria_Bacteroidetes_Cytophagia_Cytophagales_Cytophagaceae_Sunxiuqinia	Bacteria;Bacteroidetes
Bacteria_Bacteroidetes_Cytophagia_Cytophagales_Cytophagaceae_uncultured	Bacteria;Bacteroidetes
Bacteria_Bacteroidetes_Cytophagia_Cytophagales_Flammeovirgaceae_Algivirga	Bacteria;Bacteroidetes
Bacteria_Bacteroidetes_Cytophagia_Cytophagales_Flammeovirgaceae_Aureibacter	Bacteria;Bacteroidetes
Bacteria_Bacteroidetes_Cytophagia_Cytophagales_Flammeovirgaceae_Candidatus_Amoebophilus	Bacteria;Bacteroidetes
Bacteria_Bacteroidetes_Cytophagia_Cytophagales_Flammeovirgaceae_Candidatus_Cardinium	Bacteria;Bacteroidetes
Bacteria_Bacteroidetes_Cytophagia_Cytophagales_Flammeovirgaceae_Candidatus_Paenicardinium	Bacteria;Bacteroidetes
Bacteria_Bacteroidetes_Cytophagia_Cytophagales_Flammeovirgaceae_Catalinimonas	Bacteria;Bacteroidetes
Bacteria_Bacteroidetes_Cytophagia_Cytophagales_Flammeovirgaceae_Cesiribacter	Bacteria;Bacteroidetes
Bacteria_Bacteroidetes_Cytophagia_Cytophagales_Flammeovirgaceae_Ekhidna	Bacteria;Bacteroidetes
Bacteria_Bacteroidetes_Cytophagia_Cytophagales_Flammeovirgaceae_Fabibacter	Bacteria;Bacteroidetes
Bacteria_Bacteroidetes_Cytophagia_Cytophagales_Flammeovirgaceae_Flammeovirga	Bacteria;Bacteroidetes
Bacteria_Bacteroidetes_Cytophagia_Cytophagales_Flammeovirgaceae_Flexithrix	Bacteria;Bacteroidetes
Bacteria_Bacteroidetes_Cytophagia_Cytophagales_Flammeovirgaceae_Fulvitalea	Bacteria;Bacteroidetes
Bacteria_Bacteroidetes_Cytophagia_Cytophagales_Flammeovirgaceae_Fulvivirga	Bacteria;Bacteroidetes
Bacteria_Bacteroidetes_Cytophagia_Cytophagales_Flammeovirgaceae_Imperialibacter	Bacteria;Bacteroidetes
Bacteria_Bacteroidetes_Cytophagia_Cytophagales_Flammeovirgaceae_Limibacter	Bacteria;Bacteroidetes
Bacteria_Bacteroidetes_Cytophagia_Cytophagales_Flammeovirgaceae_Luteivirga	Bacteria;Bacteroidetes
Bacteria_Bacteroidetes_Cytophagia_Cytophagales_Flammeovirgaceae_Marinoscillum	Bacteria;Bacteroidetes
Bacteria_Bacteroidetes_Cytophagia_Cytophagales_Flammeovirgaceae_Marivirga	Bacteria;Bacteroidetes
Bacteria_Bacteroidetes_Cytophagia_Cytophagales_Flammeovirgaceae_Nafulsella	Bacteria;Bacteroidetes
Bacteria_Bacteroidetes_Cytophagia_Cytophagales_Flammeovirgaceae_Perexilibacter	Bacteria;Bacteroidetes
Bacteria_Bacteroidetes_Cytophagia_Cytophagales_Flammeovirgaceae_Persicobacter	Bacteria;Bacteroidetes
Bacteria_Bacteroidetes_Cytophagia_Cytophagales_Flammeovirgaceae_Rapidithrix	Bacteria;Bacteroidetes
Bacteria_Bacteroidetes_Cytophagia_Cytophagales_Flammeovirgaceae_Reichenbachiella	Bacteria;Bacteroidetes
Bacteria_Bacteroidetes_Cytophagia_Cytophagales_Flammeovirgaceae_Roseivirga	Bacteria;Bacteroidetes
Bacteria_Bacteroidetes_Cytophagia_Cytophagales_Flammeovirgaceae_Sediminitomix	Bacteria;Bacteroidetes
Bacteria_Bacteroidetes_Cytophagia_Cytophagales_Flammeovirgaceae_Tunicatimonas	Bacteria;Bacteroidetes
Bacteria_Bacteroidetes_Cytophagia_Cytophagales_Flammeovirgaceae_uncultured	Bacteria;Bacteroidetes
Bacteria_Bacteroidetes_Cytophagia_Cytophagales_MWH-CFBk5	Bacteria;Bacteroidetes
Bacteria_Bacteroidetes_Cytophagia_Cytophagales_SGUS1108	Bacteria;Bacteroidetes
Bacteria_Bacteroidetes_Cytophagia_Cytophagales_TAA-5-07	Bacteria;Bacteroidetes
Bacteria_Bacteroidetes_Cytophagia_Order_II_Rhodothermaceae	Bacteria;Bacteroidetes
Bacteria_Bacteroidetes_Cytophagia_Order_III	Bacteria;Bacteroidetes
Bacteria_Bacteroidetes_Cytophagia_Order_IV_Unknown_Family_Thermonema	Bacteria;Bacteroidetes
Bacteria_Bacteroidetes_Flavobacteriia_Flavobacteriales_Blattabacteriaceae_Blattabacterium	Bacteria;Bacteroidetes
Bacteria_Bacteroidetes_Flavobacteriia_Flavobacteriales_Blattabacteriaceae_Candidatus_Brownia	Bacteria;Bacteroidetes
Bacteria_Bacteroidetes_Flavobacteriia_Flavobacteriales_Blattabacteriaceae_Candidatus_Sulcia	Bacteria;Bacteroidetes
Bacteria_Bacteroidetes_Flavobacteriia_Flavobacteriales_Blattabacteriaceae_Candidatus_Uzinura	Bacteria;Bacteroidetes
Bacteria_Bacteroidetes_Flavobacteriia_Flavobacteriales_Blattabacteriaceae_CN77	Bacteria;Bacteroidetes
Bacteria_Bacteroidetes_Flavobacteriia_Flavobacteriales_Blattabacteriaceae_pt46	Bacteria;Bacteroidetes
Bacteria_Bacteroidetes_Flavobacteriia_Flavobacteriales_Cryomorphaceae_Brumimicrobium	Bacteria;Bacteroidetes
Bacteria_Bacteroidetes_Flavobacteriia_Flavobacteriales_Cryomorphaceae_Crocinitomix	Bacteria;Bacteroidetes
Bacteria_Bacteroidetes_Flavobacteriia_Flavobacteriales_Cryomorphaceae_Cryomorpha	Bacteria;Bacteroidetes
Bacteria_Bacteroidetes_Flavobacteriia_Flavobacteriales_Cryomorphaceae_Fluviicola	Bacteria;Bacteroidetes
Bacteria_Bacteroidetes_Flavobacteriia_Flavobacteriales_Cryomorphaceae_Lishizhenia	Bacteria;Bacteroidetes
Bacteria_Bacteroidetes_Flavobacteriia_Flavobacteriales_Cryomorphaceae_Luteibaculum	Bacteria;Bacteroidetes
Bacteria_Bacteroidetes_Flavobacteriia_Flavobacteriales_Cryomorphaceae_NS10_marine_group	Bacteria;Bacteroidetes
Bacteria_Bacteroidetes_Flavobacteriia_Flavobacteriales_Cryomorphaceae_Owenweeksia	Bacteria;Bacteroidetes
Bacteria_Bacteroidetes_Flavobacteriia_Flavobacteriales_Cryomorphaceae_Phaeocystidibacter	Bacteria;Bacteroidetes
Bacteria_Bacteroidetes_Flavobacteriia_Flavobacteriales_Cryomorphaceae_Salinirepens	Bacteria;Bacteroidetes
Bacteria_Bacteroidetes_Flavobacteriia_Flavobacteriales_Cryomorphaceae_uncultured	Bacteria;Bacteroidetes
Bacteria_Bacteroidetes_Flavobacteriia_Flavobacteriales_Cryomorphaceae_Wandonia	Bacteria;Bacteroidetes
Bacteria_Bacteroidetes_Flavobacteriia_Flavobacteriales_Flavobacteriaceae_Actibacter	Bacteria;Bacteroidetes
Bacteria_Bacteroidetes_Flavobacteriia_Flavobacteriales_Flavobacteriaceae_Aequorivita	Bacteria;Bacteroidetes
Bacteria_Bacteroidetes_Flavobacteriia_Flavobacteriales_Flavobacteriaceae_Aestuariibaculum	Bacteria;Bacteroidetes
Bacteria_Bacteroidetes_Flavobacteriia_Flavobacteriales_Flavobacteriaceae_Algibacter	Bacteria;Bacteroidetes
Bacteria_Bacteroidetes_Flavobacteriia_Flavobacteriales_Flavobacteriaceae_Antarcticimonas	Bacteria;Bacteroidetes
Bacteria_Bacteroidetes_Flavobacteriia_Flavobacteriales_Flavobacteriaceae_Aquibacter	Bacteria;Bacteroidetes
Bacteria_Bacteroidetes_Flavobacteriia_Flavobacteriales_Flavobacteriaceae_Aquimarina	Bacteria;Bacteroidetes
Bacteria_Bacteroidetes_Flavobacteriia_Flavobacteriales_Flavobacteriaceae_Arenibacter	Bacteria;Bacteroidetes
Bacteria_Bacteroidetes_Flavobacteriia_Flavobacteriales_Flavobacteriaceae_Arenitalea	Bacteria;Bacteroidetes
Bacteria_Bacteroidetes_Flavobacteriia_Flavobacteriales_Flavobacteriaceae_Aureicoccus	Bacteria;Bacteroidetes
Bacteria_Bacteroidetes_Flavobacteriia_Flavobacteriales_Flavobacteriaceae_Aureimarina	Bacteria;Bacteroidetes
Bacteria_Bacteroidetes_Flavobacteriia_Flavobacteriales_Flavobacteriaceae_Aureitalea	Bacteria;Bacteroidetes
Bacteria_Bacteroidetes_Flavobacteriia_Flavobacteriales_Flavobacteriaceae_Aureivirga	Bacteria;Bacteroidetes
Bacteria_Bacteroidetes_Flavobacteriia_Flavobacteriales_Flavobacteriaceae_Bergeyella	Bacteria;Bacteroidetes
Bacteria_Bacteroidetes_Flavobacteriia_Flavobacteriales_Flavobacteriaceae_Bizionia	Bacteria;Bacteroidetes
Bacteria_Bacteroidetes_Flavobacteriia_Flavobacteriales_Flavobacteriaceae_Candidatus_Hemobacterium	Bacteria;Bacteroidetes
Bacteria_Bacteroidetes_Flavobacteriia_Flavobacteriales_Flavobacteriaceae_Capnocytophaga	Bacteria;Bacteroidetes
Bacteria_Bacteroidetes_Flavobacteriia_Flavobacteriales_Flavobacteriaceae_Cellulophaga	Bacteria;Bacteroidetes
Bacteria_Bacteroidetes_Flavobacteriia_Flavobacteriales_Flavobacteriaceae_Chishuiella	Bacteria;Bacteroidetes
Bacteria_Bacteroidetes_Flavobacteriia_Flavobacteriales_Flavobacteriaceae_Chryseobacterium	Bacteria;Bacteroidetes
Bacteria_Bacteroidetes_Flavobacteriia_Flavobacteriales_Flavobacteriaceae_Citreitalea	Bacteria;Bacteroidetes
Bacteria_Bacteroidetes_Flavobacteriia_Flavobacteriales_Flavobacteriaceae_Cloacibacterium	Bacteria;Bacteroidetes
Bacteria_Bacteroidetes_Flavobacteriia_Flavobacteriales_Flavobacteriaceae_Coenonia	Bacteria;Bacteroidetes
Bacteria_Bacteroidetes_Flavobacteriia_Flavobacteriales_Flavobacteriaceae_Corallibacter	Bacteria;Bacteroidetes
Bacteria_Bacteroidetes_Flavobacteriia_Flavobacteriales_Flavobacteriaceae_Costertonia	Bacteria;Bacteroidetes
Bacteria_Bacteroidetes_Flavobacteriia_Flavobacteriales_Flavobacteriaceae_Croceibacter	Bacteria;Bacteroidetes
Bacteria_Bacteroidetes_Flavobacteriia_Flavobacteriales_Flavobacteriaceae_Croceitalea	Bacteria;Bacteroidetes
Bacteria_Bacteroidetes_Flavobacteriia_Flavobacteriales_Flavobacteriaceae_Cruoricaptor	Bacteria;Bacteroidetes
Bacteria_Bacteroidetes_Flavobacteriia_Flavobacteriales_Flavobacteriaceae_Dokdonia	Bacteria;Bacteroidetes
Bacteria_Bacteroidetes_Flavobacteriia_Flavobacteriales_Flavobacteriaceae_Elizabethkingia	Bacteria;Bacteroidetes
Bacteria_Bacteroidetes_Flavobacteriia_Flavobacteriales_Flavobacteriaceae_Empedobacter	Bacteria;Bacteroidetes
Bacteria_Bacteroidetes_Flavobacteriia_Flavobacteriales_Flavobacteriaceae_Epilithonimonas	Bacteria;Bacteroidetes
Bacteria_Bacteroidetes_Flavobacteriia_Flavobacteriales_Flavobacteriaceae_Eudoraea	Bacteria;Bacteroidetes
Bacteria_Bacteroidetes_Flavobacteriia_Flavobacteriales_Flavobacteriaceae_Euzebyella	Bacteria;Bacteroidetes
Bacteria_Bacteroidetes_Flavobacteriia_Flavobacteriales_Flavobacteriaceae_Flagellimonas	Bacteria;Bacteroidetes
Bacteria_Bacteroidetes_Flavobacteriia_Flavobacteriales_Flavobacteriaceae_Flaviramulus	Bacteria;Bacteroidetes
Bacteria_Bacteroidetes_Flavobacteriia_Flavobacteriales_Flavobacteriaceae_Flavivirga	Bacteria;Bacteroidetes
Bacteria_Bacteroidetes_Flavobacteriia_Flavobacteriales_Flavobacteriaceae_Flavobacterium	Bacteria;Bacteroidetes
Bacteria_Bacteroidetes_Flavobacteriia_Flavobacteriales_Flavobacteriaceae_Formosa	Bacteria;Bacteroidetes
Bacteria_Bacteroidetes_Flavobacteriia_Flavobacteriales_Flavobacteriaceae_Fulvibacter	Bacteria;Bacteroidetes
Bacteria_Bacteroidetes_Flavobacteriia_Flavobacteriales_Flavobacteriaceae_Gaetbulibacter	Bacteria;Bacteroidetes
Bacteria_Bacteroidetes_Flavobacteriia_Flavobacteriales_Flavobacteriaceae_Galbibacter	Bacteria;Bacteroidetes
Bacteria_Bacteroidetes_Flavobacteriia_Flavobacteriales_Flavobacteriaceae_Gangjinia	Bacteria;Bacteroidetes
Bacteria_Bacteroidetes_Flavobacteriia_Flavobacteriales_Flavobacteriaceae_Gelidibacter	Bacteria;Bacteroidetes
Bacteria_Bacteroidetes_Flavobacteriia_Flavobacteriales_Flavobacteriaceae_Geojedonia	Bacteria;Bacteroidetes
Bacteria_Bacteroidetes_Flavobacteriia_Flavobacteriales_Flavobacteriaceae_Gillisia	Bacteria;Bacteroidetes
Bacteria_Bacteroidetes_Flavobacteriia_Flavobacteriales_Flavobacteriaceae_Gilvibacter	Bacteria;Bacteroidetes
Bacteria_Bacteroidetes_Flavobacteriia_Flavobacteriales_Flavobacteriaceae_Gramella	Bacteria;Bacteroidetes
Bacteria_Bacteroidetes_Flavobacteriia_Flavobacteriales_Flavobacteriaceae_Hoppeia	Bacteria;Bacteroidetes
Bacteria_Bacteroidetes_Flavobacteriia_Flavobacteriales_Flavobacteriaceae_Hwangdonia	Bacteria;Bacteroidetes
Bacteria_Bacteroidetes_Flavobacteriia_Flavobacteriales_Flavobacteriaceae_Hyunsoonleella	Bacteria;Bacteroidetes
Bacteria_Bacteroidetes_Flavobacteriia_Flavobacteriales_Flavobacteriaceae_Imtechella	Bacteria;Bacteroidetes
Bacteria_Bacteroidetes_Flavobacteriia_Flavobacteriales_Flavobacteriaceae_Jejudonia	Bacteria;Bacteroidetes
Bacteria_Bacteroidetes_Flavobacteriia_Flavobacteriales_Flavobacteriaceae_Jejuia	Bacteria;Bacteroidetes
Bacteria_Bacteroidetes_Flavobacteriia_Flavobacteriales_Flavobacteriaceae_Joostella	Bacteria;Bacteroidetes
Bacteria_Bacteroidetes_Flavobacteriia_Flavobacteriales_Flavobacteriaceae_Kordia	Bacteria;Bacteroidetes
Bacteria_Bacteroidetes_Flavobacteriia_Flavobacteriales_Flavobacteriaceae_Kriegella	Bacteria;Bacteroidetes
Bacteria_Bacteroidetes_Flavobacteriia_Flavobacteriales_Flavobacteriaceae_Lacinutrix	Bacteria;Bacteroidetes
Bacteria_Bacteroidetes_Flavobacteriia_Flavobacteriales_Flavobacteriaceae_Leeuwenhoekiella	Bacteria;Bacteroidetes
Bacteria_Bacteroidetes_Flavobacteriia_Flavobacteriales_Flavobacteriaceae_Leptobacterium	Bacteria;Bacteroidetes
Bacteria_Bacteroidetes_Flavobacteriia_Flavobacteriales_Flavobacteriaceae_Lutaonella	Bacteria;Bacteroidetes
Bacteria_Bacteroidetes_Flavobacteriia_Flavobacteriales_Flavobacteriaceae_Lutibacter	Bacteria;Bacteroidetes
Bacteria_Bacteroidetes_Flavobacteriia_Flavobacteriales_Flavobacteriaceae_Lutimonas	Bacteria;Bacteroidetes
Bacteria_Bacteroidetes_Flavobacteriia_Flavobacteriales_Flavobacteriaceae_Mangrovimonas	Bacteria;Bacteroidetes
Bacteria_Bacteroidetes_Flavobacteriia_Flavobacteriales_Flavobacteriaceae_Maribacter	Bacteria;Bacteroidetes
Bacteria_Bacteroidetes_Flavobacteriia_Flavobacteriales_Flavobacteriaceae_Mariniflexile	Bacteria;Bacteroidetes
Bacteria_Bacteroidetes_Flavobacteriia_Flavobacteriales_Flavobacteriaceae_Maritimimonas	Bacteria;Bacteroidetes
Bacteria_Bacteroidetes_Flavobacteriia_Flavobacteriales_Flavobacteriaceae_Marixanthomonas	Bacteria;Bacteroidetes
Bacteria_Bacteroidetes_Flavobacteriia_Flavobacteriales_Flavobacteriaceae_Meridianimaribacter	Bacteria;Bacteroidetes
Bacteria_Bacteroidetes_Flavobacteriia_Flavobacteriales_Flavobacteriaceae_Mesoflavibacter	Bacteria;Bacteroidetes
Bacteria_Bacteroidetes_Flavobacteriia_Flavobacteriales_Flavobacteriaceae_Mesonia	Bacteria;Bacteroidetes
Bacteria_Bacteroidetes_Flavobacteriia_Flavobacteriales_Flavobacteriaceae_Moheibacter	Bacteria;Bacteroidetes
Bacteria_Bacteroidetes_Flavobacteriia_Flavobacteriales_Flavobacteriaceae_Muricauda	Bacteria;Bacteroidetes
Bacteria_Bacteroidetes_Flavobacteriia_Flavobacteriales_Flavobacteriaceae_Muriicola	Bacteria;Bacteroidetes
Bacteria_Bacteroidetes_Flavobacteriia_Flavobacteriales_Flavobacteriaceae_Myroides	Bacteria;Bacteroidetes
Bacteria_Bacteroidetes_Flavobacteriia_Flavobacteriales_Flavobacteriaceae_Nonlabens	Bacteria;Bacteroidetes
Bacteria_Bacteroidetes_Flavobacteriia_Flavobacteriales_Flavobacteriaceae_NS2b_marine_group	Bacteria;Bacteroidetes
Bacteria_Bacteroidetes_Flavobacteriia_Flavobacteriales_Flavobacteriaceae_NS3a_marine_group	Bacteria;Bacteroidetes
Bacteria_Bacteroidetes_Flavobacteriia_Flavobacteriales_Flavobacteriaceae_NS4_marine_group	Bacteria;Bacteroidetes
Bacteria_Bacteroidetes_Flavobacteriia_Flavobacteriales_Flavobacteriaceae_NS5_marine_group	Bacteria;Bacteroidetes
Bacteria_Bacteroidetes_Flavobacteriia_Flavobacteriales_Flavobacteriaceae_Olleya	Bacteria;Bacteroidetes
Bacteria_Bacteroidetes_Flavobacteriia_Flavobacteriales_Flavobacteriaceae_Ornithobacterium	Bacteria;Bacteroidetes
Bacteria_Bacteroidetes_Flavobacteriia_Flavobacteriales_Flavobacteriaceae_Pibocella	Bacteria;Bacteroidetes
Bacteria_Bacteroidetes_Flavobacteriia_Flavobacteriales_Flavobacteriaceae_Polaribacter	Bacteria;Bacteroidetes
Bacteria_Bacteroidetes_Flavobacteriia_Flavobacteriales_Flavobacteriaceae_Poriferibacter	Bacteria;Bacteroidetes
Bacteria_Bacteroidetes_Flavobacteriia_Flavobacteriales_Flavobacteriaceae_Postechiella	Bacteria;Bacteroidetes
Bacteria_Bacteroidetes_Flavobacteriia_Flavobacteriales_Flavobacteriaceae_Pricia	Bacteria;Bacteroidetes
Bacteria_Bacteroidetes_Flavobacteriia_Flavobacteriales_Flavobacteriaceae_Pseudofulvibacter	Bacteria;Bacteroidetes
Bacteria_Bacteroidetes_Flavobacteriia_Flavobacteriales_Flavobacteriaceae_Pseudozobellia	Bacteria;Bacteroidetes
Bacteria_Bacteroidetes_Flavobacteriia_Flavobacteriales_Flavobacteriaceae_Psychroflexus	Bacteria;Bacteroidetes
Bacteria_Bacteroidetes_Flavobacteriia_Flavobacteriales_Flavobacteriaceae_Psychroserpens	Bacteria;Bacteroidetes
Bacteria_Bacteroidetes_Flavobacteriia_Flavobacteriales_Flavobacteriaceae_Riemerella	Bacteria;Bacteroidetes
Bacteria_Bacteroidetes_Flavobacteriia_Flavobacteriales_Flavobacteriaceae_Robiginitalea	Bacteria;Bacteroidetes
Bacteria_Bacteroidetes_Flavobacteriia_Flavobacteriales_Flavobacteriaceae_Sabulilitoribacter	Bacteria;Bacteroidetes
Bacteria_Bacteroidetes_Flavobacteriia_Flavobacteriales_Flavobacteriaceae_Salegentibacter	Bacteria;Bacteroidetes
Bacteria_Bacteroidetes_Flavobacteriia_Flavobacteriales_Flavobacteriaceae_Salinimicrobium	Bacteria;Bacteroidetes
Bacteria_Bacteroidetes_Flavobacteriia_Flavobacteriales_Flavobacteriaceae_Sediminibacter	Bacteria;Bacteroidetes
Bacteria_Bacteroidetes_Flavobacteriia_Flavobacteriales_Flavobacteriaceae_Sediminicola	Bacteria;Bacteroidetes
Bacteria_Bacteroidetes_Flavobacteriia_Flavobacteriales_Flavobacteriaceae_Seonamhaeicola	Bacteria;Bacteroidetes
Bacteria_Bacteroidetes_Flavobacteriia_Flavobacteriales_Flavobacteriaceae_Siansivirga	Bacteria;Bacteroidetes
Bacteria_Bacteroidetes_Flavobacteriia_Flavobacteriales_Flavobacteriaceae_Sinomicrobium	Bacteria;Bacteroidetes
Bacteria_Bacteroidetes_Flavobacteriia_Flavobacteriales_Flavobacteriaceae_Snuella	Bacteria;Bacteroidetes
Bacteria_Bacteroidetes_Flavobacteriia_Flavobacteriales_Flavobacteriaceae_Soonwooa	Bacteria;Bacteroidetes
Bacteria_Bacteroidetes_Flavobacteriia_Flavobacteriales_Flavobacteriaceae_Spongiibacterium	Bacteria;Bacteroidetes
Bacteria_Bacteroidetes_Flavobacteriia_Flavobacteriales_Flavobacteriaceae_Subsaxibacter	Bacteria;Bacteroidetes
Bacteria_Bacteroidetes_Flavobacteriia_Flavobacteriales_Flavobacteriaceae_Subsaximicrobium	Bacteria;Bacteroidetes
Bacteria_Bacteroidetes_Flavobacteriia_Flavobacteriales_Flavobacteriaceae_Sufflavibacter	Bacteria;Bacteroidetes
Bacteria_Bacteroidetes_Flavobacteriia_Flavobacteriales_Flavobacteriaceae_Sungkyunkwania	Bacteria;Bacteroidetes
Bacteria_Bacteroidetes_Flavobacteriia_Flavobacteriales_Flavobacteriaceae_Tamlana	Bacteria;Bacteroidetes
Bacteria_Bacteroidetes_Flavobacteriia_Flavobacteriales_Flavobacteriaceae_Tenacibaculum	Bacteria;Bacteroidetes
Bacteria_Bacteroidetes_Flavobacteriia_Flavobacteriales_Flavobacteriaceae_Ulvibacter	Bacteria;Bacteroidetes
Bacteria_Bacteroidetes_Flavobacteriia_Flavobacteriales_Flavobacteriaceae_uncultured	Bacteria;Bacteroidetes
Bacteria_Bacteroidetes_Flavobacteriia_Flavobacteriales_Flavobacteriaceae_Vitellibacter	Bacteria;Bacteroidetes
Bacteria_Bacteroidetes_Flavobacteriia_Flavobacteriales_Flavobacteriaceae_Weeksella	Bacteria;Bacteroidetes
Bacteria_Bacteroidetes_Flavobacteriia_Flavobacteriales_Flavobacteriaceae_Wenyingzhuangia	Bacteria;Bacteroidetes
Bacteria_Bacteroidetes_Flavobacteriia_Flavobacteriales_Flavobacteriaceae_Winogradskyella	Bacteria;Bacteroidetes
Bacteria_Bacteroidetes_Flavobacteriia_Flavobacteriales_Flavobacteriaceae_Yeosuana	Bacteria;Bacteroidetes
Bacteria_Bacteroidetes_Flavobacteriia_Flavobacteriales_Flavobacteriaceae_Zeaxanthinibacter	Bacteria;Bacteroidetes
Bacteria_Bacteroidetes_Flavobacteriia_Flavobacteriales_Flavobacteriaceae_Zhouia	Bacteria;Bacteroidetes
Bacteria_Bacteroidetes_Flavobacteriia_Flavobacteriales_Flavobacteriaceae_Zobellia	Bacteria;Bacteroidetes
Bacteria_Bacteroidetes_Flavobacteriia_Flavobacteriales_Flavobacteriaceae_Zunongwangia	Bacteria;Bacteroidetes
Bacteria_Bacteroidetes_Flavobacteriia_Flavobacteriales_NS7_marine_group	Bacteria;Bacteroidetes
Bacteria_Bacteroidetes_Flavobacteriia_Flavobacteriales_NS9_marine_group	Bacteria;Bacteroidetes
Bacteria_Bacteroidetes_Flavobacteriia_Flavobacteriales_R103-B20	Bacteria;Bacteroidetes
Bacteria_Bacteroidetes_Flavobacteriia_Flavobacteriales_Schleiferiaceae_Schleiferia	Bacteria;Bacteroidetes
Bacteria_Bacteroidetes_Flavobacteriia_Flavobacteriales_uncultured	Bacteria;Bacteroidetes
Bacteria_Bacteroidetes_Ika33	Bacteria;Bacteroidetes
Bacteria_Bacteroidetes_ML602M-17	Bacteria;Bacteroidetes
Bacteria_Bacteroidetes_SB-5	Bacteria;Bacteroidetes
Bacteria_Bacteroidetes_SBXY-6786	Bacteria;Bacteroidetes
Bacteria_Bacteroidetes_SM1A07	Bacteria;Bacteroidetes
Bacteria_Bacteroidetes_Sphingobacteriia_Sphingobacteriales_AKYH767	Bacteria;Bacteroidetes
Bacteria_Bacteroidetes_Sphingobacteriia_Sphingobacteriales_B01R012	Bacteria;Bacteroidetes
Bacteria_Bacteroidetes_Sphingobacteriia_Sphingobacteriales_Chitinophagaceae_Asinibacterium	Bacteria;Bacteroidetes
Bacteria_Bacteroidetes_Sphingobacteriia_Sphingobacteriales_Chitinophagaceae_Chitinophaga	Bacteria;Bacteroidetes
Bacteria_Bacteroidetes_Sphingobacteriia_Sphingobacteriales_Chitinophagaceae_Cnuella	Bacteria;Bacteroidetes
Bacteria_Bacteroidetes_Sphingobacteriia_Sphingobacteriales_Chitinophagaceae_Crenotalea	Bacteria;Bacteroidetes
Bacteria_Bacteroidetes_Sphingobacteriia_Sphingobacteriales_Chitinophagaceae_Ferruginibacter	Bacteria;Bacteroidetes
Bacteria_Bacteroidetes_Sphingobacteriia_Sphingobacteriales_Chitinophagaceae_Filimonas	Bacteria;Bacteroidetes
Bacteria_Bacteroidetes_Sphingobacteriia_Sphingobacteriales_Chitinophagaceae_Flavihumibacter	Bacteria;Bacteroidetes
Bacteria_Bacteroidetes_Sphingobacteriia_Sphingobacteriales_Chitinophagaceae_Flavisolibacter	Bacteria;Bacteroidetes
Bacteria_Bacteroidetes_Sphingobacteriia_Sphingobacteriales_Chitinophagaceae_Flavitalea	Bacteria;Bacteroidetes
Bacteria_Bacteroidetes_Sphingobacteriia_Sphingobacteriales_Chitinophagaceae_Heliimonas	Bacteria;Bacteroidetes
Bacteria_Bacteroidetes_Sphingobacteriia_Sphingobacteriales_Chitinophagaceae_Hydrotalea	Bacteria;Bacteroidetes
Bacteria_Bacteroidetes_Sphingobacteriia_Sphingobacteriales_Chitinophagaceae_Lacibacter	Bacteria;Bacteroidetes
Bacteria_Bacteroidetes_Sphingobacteriia_Sphingobacteriales_Chitinophagaceae_Niabella	Bacteria;Bacteroidetes
Bacteria_Bacteroidetes_Sphingobacteriia_Sphingobacteriales_Chitinophagaceae_Niastella	Bacteria;Bacteroidetes
Bacteria_Bacteroidetes_Sphingobacteriia_Sphingobacteriales_Chitinophagaceae_Parafilimonas	Bacteria;Bacteroidetes
Bacteria_Bacteroidetes_Sphingobacteriia_Sphingobacteriales_Chitinophagaceae_Parasegetibacter	Bacteria;Bacteroidetes
Bacteria_Bacteroidetes_Sphingobacteriia_Sphingobacteriales_Chitinophagaceae_Sediminibacterium	Bacteria;Bacteroidetes
Bacteria_Bacteroidetes_Sphingobacteriia_Sphingobacteriales_Chitinophagaceae_Segetibacter	Bacteria;Bacteroidetes
Bacteria_Bacteroidetes_Sphingobacteriia_Sphingobacteriales_Chitinophagaceae_Taibaiella	Bacteria;Bacteroidetes
Bacteria_Bacteroidetes_Sphingobacteriia_Sphingobacteriales_Chitinophagaceae_Terrimonas	Bacteria;Bacteroidetes
Bacteria_Bacteroidetes_Sphingobacteriia_Sphingobacteriales_Chitinophagaceae_uncultured	Bacteria;Bacteroidetes
Bacteria_Bacteroidetes_Sphingobacteriia_Sphingobacteriales_Chitinophagaceae_Vibrionimonas	Bacteria;Bacteroidetes
Bacteria_Bacteroidetes_Sphingobacteriia_Sphingobacteriales_CMW-169	Bacteria;Bacteroidetes
Bacteria_Bacteroidetes_Sphingobacteriia_Sphingobacteriales_CWT_CU03-E12	Bacteria;Bacteroidetes
Bacteria_Bacteroidetes_Sphingobacteriia_Sphingobacteriales_E6aC02	Bacteria;Bacteroidetes
Bacteria_Bacteroidetes_Sphingobacteriia_Sphingobacteriales_env.OPS_17	Bacteria;Bacteroidetes
Bacteria_Bacteroidetes_Sphingobacteriia_Sphingobacteriales_FFCH9454	Bacteria;Bacteroidetes
Bacteria_Bacteroidetes_Sphingobacteriia_Sphingobacteriales_KD1-131	Bacteria;Bacteroidetes
Bacteria_Bacteroidetes_Sphingobacteriia_Sphingobacteriales_KD3-93	Bacteria;Bacteroidetes
Bacteria_Bacteroidetes_Sphingobacteriia_Sphingobacteriales_LiUU-11-161	Bacteria;Bacteroidetes
Bacteria_Bacteroidetes_Sphingobacteriia_Sphingobacteriales_NS11-12_marine_group	Bacteria;Bacteroidetes
Bacteria_Bacteroidetes_Sphingobacteriia_Sphingobacteriales_PHOS-HE51	Bacteria;Bacteroidetes
Bacteria_Bacteroidetes_Sphingobacteriia_Sphingobacteriales_S15-21	Bacteria;Bacteroidetes
Bacteria_Bacteroidetes_Sphingobacteriia_Sphingobacteriales_S15A-MN91	Bacteria;Bacteroidetes
Bacteria_Bacteroidetes_Sphingobacteriia_Sphingobacteriales_s74e-6049	Bacteria;Bacteroidetes
Bacteria_Bacteroidetes_Sphingobacteriia_Sphingobacteriales_Saprospiraceae_Aureispira	Bacteria;Bacteroidetes
Bacteria_Bacteroidetes_Sphingobacteriia_Sphingobacteriales_Saprospiraceae_Candidatus_Aquirestis	Bacteria;Bacteroidetes
Bacteria_Bacteroidetes_Sphingobacteriia_Sphingobacteriales_Saprospiraceae_Haliscomenobacter	Bacteria;Bacteroidetes
Bacteria_Bacteroidetes_Sphingobacteriia_Sphingobacteriales_Saprospiraceae_Lewinella	Bacteria;Bacteroidetes
Bacteria_Bacteroidetes_Sphingobacteriia_Sphingobacteriales_Saprospiraceae_Phaeodactylibacter	Bacteria;Bacteroidetes
Bacteria_Bacteroidetes_Sphingobacteriia_Sphingobacteriales_Saprospiraceae_Portibacter	Bacteria;Bacteroidetes
Bacteria_Bacteroidetes_Sphingobacteriia_Sphingobacteriales_Saprospiraceae_Rubidimonas	Bacteria;Bacteroidetes
Bacteria_Bacteroidetes_Sphingobacteriia_Sphingobacteriales_Saprospiraceae_Saprospira	Bacteria;Bacteroidetes
Bacteria_Bacteroidetes_Sphingobacteriia_Sphingobacteriales_Saprospiraceae_uncultured	Bacteria;Bacteroidetes
Bacteria_Bacteroidetes_Sphingobacteriia_Sphingobacteriales_SBYC-2600	Bacteria;Bacteroidetes
Bacteria_Bacteroidetes_Sphingobacteriia_Sphingobacteriales_Sphingobacteriaceae	Bacteria;Bacteroidetes
Bacteria_Bacteroidetes_Sphingobacteriia_Sphingobacteriales_ST-12K33	Bacteria;Bacteroidetes
Bacteria_Bacteroidetes_Sphingobacteriia_Sphingobacteriales_WCHB1-69	Bacteria;Bacteroidetes
Bacteria_Bacteroidetes_Sphingobacteriia_Sphingobacteriales_Z4MB62	Bacteria;Bacteroidetes
Bacteria_Bacteroidetes_WCHB1-32	Bacteria;Bacteroidetes
Bacteria_Caldiserica_Caldisericia_Caldisericales_08D2Z23	Bacteria;Others
Bacteria_Caldiserica_Caldisericia_Caldisericales_Caldisericaceae_Caldisericum	Bacteria;Others
Bacteria_Caldiserica_Caldisericia_Caldisericales_LF045	Bacteria;Others
Bacteria_Caldiserica_Caldisericia_Caldisericales_TTA-B1	Bacteria;Others
Bacteria_Caldiserica_Caldisericia_Caldisericales_TTA-B15	Bacteria;Others
Bacteria_Caldiserica_Caldisericia_Caldisericales_WCHB1-02	Bacteria;Others
Bacteria_Calescamantes	Bacteria;Others
Bacteria_Candidate_division_OP3	Bacteria;Others
Bacteria_Candidate_division_SR1	Bacteria;Others
Bacteria_Candidate_division_WS6	Bacteria;Others
Bacteria_Chlamydiae_Chlamydiae_Chlamydiales	Bacteria;Others
Bacteria_Chlorobi_Chlorobia_Chlorobiales_Chlorobiaceae	Bacteria;Others
Bacteria_Chlorobi_Chlorobia_Chlorobiales_OPB56	Bacteria;Others
Bacteria_Chlorobi_Chlorobia_Chlorobiales_SJA-28	Bacteria;Others
Bacteria_Chlorobi_Ignavibacteria_Ignavibacteriales_BSN166	Bacteria;Others
Bacteria_Chlorobi_Ignavibacteria_Ignavibacteriales_BSV26	Bacteria;Others
Bacteria_Chlorobi_Ignavibacteria_Ignavibacteriales_BSV40	Bacteria;Others
Bacteria_Chlorobi_Ignavibacteria_Ignavibacteriales_Ignavibacteriaceae_Ignavibacterium	Bacteria;Others
Bacteria_Chlorobi_Ignavibacteria_Ignavibacteriales_Ignavibacteriales_Incertae_Sedis_Melioribacter	Bacteria;Others
Bacteria_Chlorobi_Ignavibacteria_Ignavibacteriales_IheB3-7	Bacteria;Others
Bacteria_Chlorobi_Ignavibacteria_Ignavibacteriales_LD-RB-34	Bacteria;Others
Bacteria_Chlorobi_Ignavibacteria_Ignavibacteriales_PHOS-HE36	Bacteria;Others
Bacteria_Chlorobi_Ignavibacteria_Ignavibacteriales_SM1H02	Bacteria;Others
Bacteria_Chlorobi_Ignavibacteria_Ignavibacteriales_SR-FBR-L83	Bacteria;Others
Bacteria_Chloroflexi_Anaerolineae_Anaerolineales_Anaerolineaceae_Anaerolinea	Bacteria;Others
Bacteria_Chloroflexi_Anaerolineae_Anaerolineales_Anaerolineaceae_Anaerolineaceae_UCG-001	Bacteria;Others
Bacteria_Chloroflexi_Anaerolineae_Anaerolineales_Anaerolineaceae_Bellilinea	Bacteria;Others
Bacteria_Chloroflexi_Anaerolineae_Anaerolineales_Anaerolineaceae_Leptolinea	Bacteria;Others
Bacteria_Chloroflexi_Anaerolineae_Anaerolineales_Anaerolineaceae_Levilinea	Bacteria;Others
Bacteria_Chloroflexi_Anaerolineae_Anaerolineales_Anaerolineaceae_Longilinea	Bacteria;Others
Bacteria_Chloroflexi_Anaerolineae_Anaerolineales_Anaerolineaceae_Ornatilinea	Bacteria;Others
Bacteria_Chloroflexi_Anaerolineae_Anaerolineales_Anaerolineaceae_Pelolinea	Bacteria;Others
Bacteria_Chloroflexi_Anaerolineae_Anaerolineales_Anaerolineaceae_Thermanaerothrix	Bacteria;Others
Bacteria_Chloroflexi_Anaerolineae_Anaerolineales_Anaerolineaceae_Thermomarinilinea	Bacteria;Others
Bacteria_Chloroflexi_Anaerolineae_Anaerolineales_Anaerolineaceae_uncultured	Bacteria;Others
Bacteria_Chloroflexi_Ardenticatenia_Ardenticatenales_Ardenticatenaceae_Ardenticatena	Bacteria;Others
Bacteria_Chloroflexi_Ardenticatenia_uncultured	Bacteria;Others
Bacteria_Chloroflexi_Caldilineae_Caldilineales_Caldilineaceae_Caldilinea	Bacteria;Others
Bacteria_Chloroflexi_Caldilineae_Caldilineales_Caldilineaceae_Litorilinea	Bacteria;Others
Bacteria_Chloroflexi_Caldilineae_Caldilineales_Caldilineaceae_uncultured	Bacteria;Others
Bacteria_Chloroflexi_Chloroflexi_Incertae_Sedis_Unknown_Order_Unknown_Family_Thermobaculum	Bacteria;Others
Bacteria_Chloroflexi_Chloroflexia_Chloroflexales_Chloroflexaceae	Bacteria;Others
Bacteria_Chloroflexi_Chloroflexia_Chloroflexales_Chloroflexales_Incertae_Sedis_Candidatus_Chlorothrix	Bacteria;Others
Bacteria_Chloroflexi_Chloroflexia_Chloroflexales_FFCH7168	Bacteria;Others
Bacteria_Chloroflexi_Chloroflexia_Chloroflexales_Oscillochloridaceae_Oscillochloris	Bacteria;Others
Bacteria_Chloroflexi_Chloroflexia_Chloroflexales_Roseiflexaceae_Roseiflexus	Bacteria;Others
Bacteria_Chloroflexi_Chloroflexia_Chloroflexales_uncultured	Bacteria;Others
Bacteria_Chloroflexi_Chloroflexia_Herpetosiphonales_Herpetosiphonaceae_Herpetosiphon	Bacteria;Others
Bacteria_Chloroflexi_Chloroflexia_Kallotenuales	Bacteria;Others
Bacteria_Chloroflexi_Dehalococcoidia_Dehalococcoidales_Dehalococcoidaceae	Bacteria;Others
Bacteria_Chloroflexi_Dehalococcoidia_Dehalococcoidales_Dehalococcoidales_Incertae_Sedis_Dehalobium	Bacteria;Others
Bacteria_Chloroflexi_Dehalococcoidia_Dehalococcoidales_uncultured	Bacteria;Others
Bacteria_Chloroflexi_Dehalococcoidia_FS117-23B-02	Bacteria;Others
Bacteria_Chloroflexi_Dehalococcoidia_FW22	Bacteria;Others
Bacteria_Chloroflexi_Dehalococcoidia_GIF3	Bacteria;Others
Bacteria_Chloroflexi_Dehalococcoidia_GIF9	Bacteria;Others
Bacteria_Chloroflexi_Dehalococcoidia_MSBL5	Bacteria;Others
Bacteria_Chloroflexi_Dehalococcoidia_Napoli-4B-65	Bacteria;Others
Bacteria_Chloroflexi_Dehalococcoidia_Sh765B-AG-111	Bacteria;Others
Bacteria_Chloroflexi_Dehalococcoidia_vadinBA26	Bacteria;Others
Bacteria_Chloroflexi_Elev-1554	Bacteria;Others
Bacteria_Chloroflexi_Gitt-GS-136	Bacteria;Others
Bacteria_Chloroflexi_JG30-KF-CM66	Bacteria;Others
Bacteria_Chloroflexi_JG37-AG-4	Bacteria;Others
Bacteria_Chloroflexi_KD4-96	Bacteria;Others
Bacteria_Chloroflexi_Ktedonobacteria_B10-SB3A	Bacteria;Others
Bacteria_Chloroflexi_Ktedonobacteria_B12-WMSP1	Bacteria;Others
Bacteria_Chloroflexi_Ktedonobacteria_C0119	Bacteria;Others
Bacteria_Chloroflexi_Ktedonobacteria_FFCH11981	Bacteria;Others
Bacteria_Chloroflexi_Ktedonobacteria_JG30-KF-AS9	Bacteria;Others
Bacteria_Chloroflexi_Ktedonobacteria_Ktedonobacterales_1921-3	Bacteria;Others
Bacteria_Chloroflexi_Ktedonobacteria_Ktedonobacterales_1959-1	Bacteria;Others
Bacteria_Chloroflexi_Ktedonobacteria_Ktedonobacterales_BacC-u-018	Bacteria;Others
Bacteria_Chloroflexi_Ktedonobacteria_Ktedonobacterales_FCPS473	Bacteria;Others
Bacteria_Chloroflexi_Ktedonobacteria_Ktedonobacterales_G12-WMSP1	Bacteria;Others
Bacteria_Chloroflexi_Ktedonobacteria_Ktedonobacterales_HSB_OF53-F07	Bacteria;Others
Bacteria_Chloroflexi_Ktedonobacteria_Ktedonobacterales_JG30a-KF-32	Bacteria;Others
Bacteria_Chloroflexi_Ktedonobacteria_Ktedonobacterales_Ktedonobacteraceae_Ktedonobacter	Bacteria;Others
Bacteria_Chloroflexi_Ktedonobacteria_Ktedonobacterales_Ktedonobacteraceae_uncultured	Bacteria;Others
Bacteria_Chloroflexi_Ktedonobacteria_Ktedonobacterales_Thermosporotrichaceae	Bacteria;Others
Bacteria_Chloroflexi_Ktedonobacteria_MVP-21	Bacteria;Others
Bacteria_Chloroflexi_Ktedonobacteria_Thermogemmatisporales	Bacteria;Others
Bacteria_Chloroflexi_KZNMV-5-B42	Bacteria;Others
Bacteria_Chloroflexi_MSB-5B2	Bacteria;Others
Bacteria_Chloroflexi_P2-11E	Bacteria;Others
Bacteria_Chloroflexi_S085	Bacteria;Others
Bacteria_Chloroflexi_SAR202_clade	Bacteria;Others
Bacteria_Chloroflexi_SHA-26	Bacteria;Others
Bacteria_Chloroflexi_SL56_marine_group	Bacteria;Others
Bacteria_Chloroflexi_Thermoflexia_Thermoflexales_Thermoflexaceae_Thermoflexus	Bacteria;Others
Bacteria_Chloroflexi_Thermomicrobia_AKYG1722	Bacteria;Others
Bacteria_Chloroflexi_Thermomicrobia_JG30-KF-CM45	Bacteria;Others
Bacteria_Chloroflexi_Thermomicrobia_Sphaerobacterales_Sphaerobacteraceae	Bacteria;Others
Bacteria_Chloroflexi_Thermomicrobia_Thermomicrobiales_Thermomicrobiaceae_Thermomicrobium	Bacteria;Others
Bacteria_Chloroflexi_TK10	Bacteria;Others
Bacteria_Chloroflexi_uncultured	Bacteria;Others
Bacteria_Chrysiogenetes_Chrysiogenetes_Chrysiogenales_Chrysiogenaceae	Bacteria;Others
Bacteria_CKC4	Bacteria;Others
Bacteria_Cloacimonetes_C-2	Bacteria;Others
Bacteria_Cloacimonetes_Cloacimonetes_Incertae_Sedis_Unknown_Order_Unknown_Family_Candidatus_Cloacamonas	Bacteria;Others
Bacteria_Cloacimonetes_CW-1_termite_group	Bacteria;Others
Bacteria_Cloacimonetes_FGL12-B44	Bacteria;Others
Bacteria_Cloacimonetes_GZKB75	Bacteria;Others
Bacteria_Cloacimonetes_LK-44f	Bacteria;Others
Bacteria_Cloacimonetes_LNR_A2-18	Bacteria;Others
Bacteria_Cloacimonetes_MSBL2	Bacteria;Others
Bacteria_Cloacimonetes_MSBL8	Bacteria;Others
Bacteria_Cloacimonetes_NK-L14	Bacteria;Others
Bacteria_Cloacimonetes_PBS-18	Bacteria;Others
Bacteria_Cloacimonetes_SHA-4	Bacteria;Others
Bacteria_Cloacimonetes_SHA-41	Bacteria;Others
Bacteria_Cloacimonetes_W27	Bacteria;Others
Bacteria_Cloacimonetes_W5	Bacteria;Others
Bacteria_Cyanobacteria_Chloroplast	Bacteria;Cyanobacteria
Bacteria_Cyanobacteria_Cyanobacteria_SubsectionI_FamilyI	Bacteria;Cyanobacteria
Bacteria_Cyanobacteria_Cyanobacteria_SubsectionII	Bacteria;Cyanobacteria
Bacteria_Cyanobacteria_Cyanobacteria_SubsectionIII_FamilyI_Aerosakkonema	Bacteria;Cyanobacteria
Bacteria_Cyanobacteria_Cyanobacteria_SubsectionIII_FamilyI_Arthronema	Bacteria;Cyanobacteria
Bacteria_Cyanobacteria_Cyanobacteria_SubsectionIII_FamilyI_Arthrospira	Bacteria;Cyanobacteria
Bacteria_Cyanobacteria_Cyanobacteria_SubsectionIII_FamilyI_Chamaesiphon	Bacteria;Cyanobacteria
Bacteria_Cyanobacteria_Cyanobacteria_SubsectionIII_FamilyI_Coleofasciculus	Bacteria;Cyanobacteria
Bacteria_Cyanobacteria_Cyanobacteria_SubsectionIII_FamilyI_Crinalium	Bacteria;Cyanobacteria
Bacteria_Cyanobacteria_Cyanobacteria_SubsectionIII_FamilyI_Dactylococcopsis	Bacteria;Cyanobacteria
Bacteria_Cyanobacteria_Cyanobacteria_SubsectionIII_FamilyI_Euhalothece	Bacteria;Cyanobacteria
Bacteria_Cyanobacteria_Cyanobacteria_SubsectionIII_FamilyI_Geitlerinema	Bacteria;Cyanobacteria
Bacteria_Cyanobacteria_Cyanobacteria_SubsectionIII_FamilyI_Haloleptolyngbya	Bacteria;Cyanobacteria
Bacteria_Cyanobacteria_Cyanobacteria_SubsectionIII_FamilyI_Halomicronema	Bacteria;Cyanobacteria
Bacteria_Cyanobacteria_Cyanobacteria_SubsectionIII_FamilyI_Leptolyngbya	Bacteria;Cyanobacteria
Bacteria_Cyanobacteria_Cyanobacteria_SubsectionIII_FamilyI_Limnothrix	Bacteria;Cyanobacteria
Bacteria_Cyanobacteria_Cyanobacteria_SubsectionIII_FamilyI_Lyngbya	Bacteria;Cyanobacteria
Bacteria_Cyanobacteria_Cyanobacteria_SubsectionIII_FamilyI_Microcoleus	Bacteria;Cyanobacteria
Bacteria_Cyanobacteria_Cyanobacteria_SubsectionIII_FamilyI_Oscillatoria	Bacteria;Cyanobacteria
Bacteria_Cyanobacteria_Cyanobacteria_SubsectionIII_FamilyI_Phormidium	Bacteria;Cyanobacteria
Bacteria_Cyanobacteria_Cyanobacteria_SubsectionIII_FamilyI_Planktothricoides	Bacteria;Cyanobacteria
Bacteria_Cyanobacteria_Cyanobacteria_SubsectionIII_FamilyI_Planktothrix	Bacteria;Cyanobacteria
Bacteria_Cyanobacteria_Cyanobacteria_SubsectionIII_FamilyI_Prochlorothrix	Bacteria;Cyanobacteria
Bacteria_Cyanobacteria_Cyanobacteria_SubsectionIII_FamilyI_Pseudanabaena	Bacteria;Cyanobacteria
Bacteria_Cyanobacteria_Cyanobacteria_SubsectionIII_FamilyI_Rubidibacter	Bacteria;Cyanobacteria
Bacteria_Cyanobacteria_Cyanobacteria_SubsectionIII_FamilyI_Spirulina	Bacteria;Cyanobacteria
Bacteria_Cyanobacteria_Cyanobacteria_SubsectionIII_FamilyI_Symploca	Bacteria;Cyanobacteria
Bacteria_Cyanobacteria_Cyanobacteria_SubsectionIII_FamilyI_Trichocoleus	Bacteria;Cyanobacteria
Bacteria_Cyanobacteria_Cyanobacteria_SubsectionIII_FamilyI_Trichodesmium	Bacteria;Cyanobacteria
Bacteria_Cyanobacteria_Cyanobacteria_SubsectionIII_FamilyI_Tychonema	Bacteria;Cyanobacteria
Bacteria_Cyanobacteria_Cyanobacteria_SubsectionIII_FamilyI_uncultured	Bacteria;Cyanobacteria
Bacteria_Cyanobacteria_Cyanobacteria_SubsectionIV	Bacteria;Cyanobacteria
Bacteria_Cyanobacteria_Cyanobacteria_SubsectionV_FamilyI	Bacteria;Cyanobacteria
Bacteria_Cyanobacteria_Cyanobacteria_uncultured	Bacteria;Cyanobacteria
Bacteria_Cyanobacteria_Melainabacteria_Caenarcaniphilales	Bacteria;Cyanobacteria
Bacteria_Cyanobacteria_Melainabacteria_Gastranaerophilales	Bacteria;Cyanobacteria
Bacteria_Cyanobacteria_Melainabacteria_Obscuribacterales	Bacteria;Cyanobacteria
Bacteria_Cyanobacteria_Melainabacteria_Vampirovibrionales	Bacteria;Cyanobacteria
Bacteria_Cyanobacteria_ML635J-21	Bacteria;Cyanobacteria
Bacteria_Deferribacteres_Deferribacteres_Deferribacterales_Deferribacteraceae_Calditerrivibrio	Bacteria;Others
Bacteria_Deferribacteres_Deferribacteres_Deferribacterales_Deferribacteraceae_Deferribacter	Bacteria;Others
Bacteria_Deferribacteres_Deferribacteres_Deferribacterales_Deferribacteraceae_Denitrovibrio	Bacteria;Others
Bacteria_Deferribacteres_Deferribacteres_Deferribacterales_Deferribacteraceae_Flexistipes	Bacteria;Others
Bacteria_Deferribacteres_Deferribacteres_Deferribacterales_Deferribacteraceae_Geovibrio	Bacteria;Others
Bacteria_Deferribacteres_Deferribacteres_Deferribacterales_Deferribacteraceae_Mucispirillum	Bacteria;Others
Bacteria_Deferribacteres_Deferribacteres_Deferribacterales_Deferribacteraceae_uncultured	Bacteria;Others
Bacteria_Deferribacteres_Deferribacteres_Incertae_Sedis_Unknown_Order_Unknown_Family_Caldithrix	Bacteria;Others
Bacteria_Deinococcus-Thermus_Deinococci_Deinococcales_Deinococcaceae	Bacteria;Others
Bacteria_Deinococcus-Thermus_Deinococci_Deinococcales_Trueperaceae_Truepera	Bacteria;Others
Bacteria_Deinococcus-Thermus_Deinococci_KD3-62	Bacteria;Others
Bacteria_Deinococcus-Thermus_Deinococci_Thermales_Thermaceae	Bacteria;Others
Bacteria_Dictyoglomi_Dictyoglomia_Dictyoglomales_Dictyoglomaceae_Dictyoglomus	Bacteria;Others
Bacteria_Elusimicrobia_Elusimicrobia_12-31	Bacteria;Others
Bacteria_Elusimicrobia_Elusimicrobia_Elusimicrobiales_Elusimicrobiaceae_Elusimicrobium	Bacteria;Others
Bacteria_Elusimicrobia_Elusimicrobia_FCPU453	Bacteria;Others
Bacteria_Elusimicrobia_Elusimicrobia_Lineage_I_Unknown_Family_Candidatus_Endomicrobium	Bacteria;Others
Bacteria_Elusimicrobia_Elusimicrobia_Lineage_IIa	Bacteria;Others
Bacteria_Elusimicrobia_Elusimicrobia_Lineage_IIb	Bacteria;Others
Bacteria_Elusimicrobia_Elusimicrobia_Lineage_IIc	Bacteria;Others
Bacteria_Elusimicrobia_Elusimicrobia_Lineage_IV	Bacteria;Others
Bacteria_Elusimicrobia_Elusimicrobia_MD2894-B20	Bacteria;Others
Bacteria_Elusimicrobia_Elusimicrobia_MVP-88	Bacteria;Others
Bacteria_Elusimicrobia_Elusimicrobia_Rs-M47	Bacteria;Others
Bacteria_Fibrobacteres_Chitinivibrionia_Chitinivibrionales_Chitinivibrionaceae	Bacteria;Others
Bacteria_Fibrobacteres_Chitinivibrionia_Chitinivibrionia_Incertae_Sedis_Unknown_Family_possible_genus_02	Bacteria;Others
Bacteria_Fibrobacteres_Chitinivibrionia_possible_order_07	Bacteria;Others
Bacteria_Fibrobacteres_Fibrobacteria_Fibrobacterales_09D2Z46	Bacteria;Others
Bacteria_Fibrobacteres_Fibrobacteria_Fibrobacterales_09D2Z48	Bacteria;Others
Bacteria_Fibrobacteres_Fibrobacteria_Fibrobacterales_B122	Bacteria;Others
Bacteria_Fibrobacteres_Fibrobacteria_Fibrobacterales_B18	Bacteria;Others
Bacteria_Fibrobacteres_Fibrobacteria_Fibrobacterales_FD035	Bacteria;Others
Bacteria_Fibrobacteres_Fibrobacteria_Fibrobacterales_Fibrobacteraceae_Fibrobacter	Bacteria;Others
Bacteria_Fibrobacteres_Fibrobacteria_Fibrobacterales_Fibrobacteraceae_possible_genus_04	Bacteria;Others
Bacteria_Fibrobacteres_Fibrobacteria_Fibrobacterales_Fibrobacteraceae_possible_genus_05	Bacteria;Others
Bacteria_Fibrobacteres_Fibrobacteria_Fibrobacterales_Fibrobacteraceae_possible_genus_06	Bacteria;Others
Bacteria_Fibrobacteres_Fibrobacteria_Fibrobacterales_Fibrobacteraceae_uncultured	Bacteria;Others
Bacteria_Fibrobacteres_Fibrobacteria_Fibrobacterales_MAT-CR-H6-H10	Bacteria;Others
Bacteria_Fibrobacteres_Fibrobacteria_Fibrobacterales_possible_family_01	Bacteria;Others
Bacteria_Fibrobacteres_Fibrobacteria_Fibrobacterales_possible_family_02	Bacteria;Others
Bacteria_Fibrobacteres_Fibrobacteria_Fibrobacterales_SBXY-748	Bacteria;Others
Bacteria_Fibrobacteres_Fibrobacteria_Fibrobacterales_SBYC	Bacteria;Others
Bacteria_Fibrobacteres_Fibrobacteria_Fibrobacterales_SBYS-2995	Bacteria;Others
Bacteria_Fibrobacteres_Fibrobacteria_Fibrobacterales_SBYZ-1017	Bacteria;Others
Bacteria_Firmicutes_Bacilli_4-15	Bacteria;Firmicutes
Bacteria_Firmicutes_Bacilli_Bacillales_Alicyclobacillaceae	Bacteria;Firmicutes
Bacteria_Firmicutes_Bacilli_Bacillales_Bacillaceae	Bacteria;Firmicutes
Bacteria_Firmicutes_Bacilli_Bacillales_Family_X_Thermicanus	Bacteria;Firmicutes
Bacteria_Firmicutes_Bacilli_Bacillales_Family_XI_Gemella	Bacteria;Firmicutes
Bacteria_Firmicutes_Bacilli_Bacillales_Family_XII_Exiguobacterium	Bacteria;Firmicutes
Bacteria_Firmicutes_Bacilli_Bacillales_Family_XII_Incertae_Sedis	Bacteria;Firmicutes
Bacteria_Firmicutes_Bacilli_Bacillales_Listeriaceae	Bacteria;Firmicutes
Bacteria_Firmicutes_Bacilli_Bacillales_Paenibacillaceae	Bacteria;Firmicutes
Bacteria_Firmicutes_Bacilli_Bacillales_Pasteuriaceae_Pasteuria	Bacteria;Firmicutes
Bacteria_Firmicutes_Bacilli_Bacillales_Planococcaceae	Bacteria;Firmicutes
Bacteria_Firmicutes_Bacilli_Bacillales_Sporolactobacillaceae	Bacteria;Firmicutes
Bacteria_Firmicutes_Bacilli_Bacillales_Staphylococcaceae	Bacteria;Firmicutes
Bacteria_Firmicutes_Bacilli_Bacillales_Thermoactinomycetaceae	Bacteria;Firmicutes
Bacteria_Firmicutes_Bacilli_Bacillales_uncultured	Bacteria;Firmicutes
Bacteria_Firmicutes_Bacilli_C178B	Bacteria;Firmicutes
Bacteria_Firmicutes_Bacilli_Lactobacillales_16d63.751	Bacteria;Firmicutes
Bacteria_Firmicutes_Bacilli_Lactobacillales_Aerococcaceae	Bacteria;Firmicutes
Bacteria_Firmicutes_Bacilli_Lactobacillales_Carnobacteriaceae	Bacteria;Firmicutes
Bacteria_Firmicutes_Bacilli_Lactobacillales_Enterococcaceae	Bacteria;Firmicutes
Bacteria_Firmicutes_Bacilli_Lactobacillales_Lactobacillaceae_Lactobacillus	Bacteria;Firmicutes
Bacteria_Firmicutes_Bacilli_Lactobacillales_Lactobacillaceae_Pediococcus	Bacteria;Firmicutes
Bacteria_Firmicutes_Bacilli_Lactobacillales_Leuconostocaceae	Bacteria;Firmicutes
Bacteria_Firmicutes_Bacilli_Lactobacillales_Ll142-3M24	Bacteria;Firmicutes
Bacteria_Firmicutes_Bacilli_Lactobacillales_MOB164	Bacteria;Firmicutes
Bacteria_Firmicutes_Bacilli_Lactobacillales_P5D1-392	Bacteria;Firmicutes
Bacteria_Firmicutes_Bacilli_Lactobacillales_PeH08	Bacteria;Firmicutes
Bacteria_Firmicutes_Bacilli_Lactobacillales_Rs-D42	Bacteria;Firmicutes
Bacteria_Firmicutes_Bacilli_Lactobacillales_Streptococcaceae	Bacteria;Firmicutes
Bacteria_Firmicutes_Bacilli_RS-F29	Bacteria;Firmicutes
Bacteria_Firmicutes_Bacilli_SHBZ1548	Bacteria;Firmicutes
Bacteria_Firmicutes_Bacilli_uncultured	Bacteria;Firmicutes
Bacteria_Firmicutes_Clostridia_Clostridia_Incertae_Sedis_Unknown_Family_Candidatus_Desulforudis	Bacteria;Firmicutes
Bacteria_Firmicutes_Clostridia_Clostridiales_9B-04	Bacteria;Firmicutes
Bacteria_Firmicutes_Clostridia_Clostridiales_Caldicoprobacteraceae_Caldicoprobacter	Bacteria;Firmicutes
Bacteria_Firmicutes_Clostridia_Clostridiales_Christensenellaceae_Catabacter	Bacteria;Firmicutes
Bacteria_Firmicutes_Clostridia_Clostridiales_Christensenellaceae_Christensenella	Bacteria;Firmicutes
Bacteria_Firmicutes_Clostridia_Clostridiales_Christensenellaceae_Christensenellaceae_R-7_group	Bacteria;Firmicutes
Bacteria_Firmicutes_Clostridia_Clostridiales_Christensenellaceae_uncultured	Bacteria;Firmicutes
Bacteria_Firmicutes_Clostridia_Clostridiales_Clostridiaceae_1	Bacteria;Firmicutes
Bacteria_Firmicutes_Clostridia_Clostridiales_Clostridiaceae_2_Alkaliphilus	Bacteria;Firmicutes
Bacteria_Firmicutes_Clostridia_Clostridiales_Clostridiaceae_2_Anaerovirgula	Bacteria;Firmicutes
Bacteria_Firmicutes_Clostridia_Clostridiales_Clostridiaceae_2_Anoxynatronum	Bacteria;Firmicutes
Bacteria_Firmicutes_Clostridia_Clostridiales_Clostridiaceae_2_Clostridium_sensu_stricto	Bacteria;Firmicutes
Bacteria_Firmicutes_Clostridia_Clostridiales_Clostridiaceae_2_Natronincola	Bacteria;Firmicutes
Bacteria_Firmicutes_Clostridia_Clostridiales_Clostridiaceae_2_Tindallia	Bacteria;Firmicutes
Bacteria_Firmicutes_Clostridia_Clostridiales_Clostridiaceae_3	Bacteria;Firmicutes
Bacteria_Firmicutes_Clostridia_Clostridiales_Clostridiaceae_4	Bacteria;Firmicutes
Bacteria_Firmicutes_Clostridia_Clostridiales_Clostridiales_Incertae_Sedis	Bacteria;Firmicutes
Bacteria_Firmicutes_Clostridia_Clostridiales_Clostridiales_vadinBB60_group	Bacteria;Firmicutes
Bacteria_Firmicutes_Clostridia_Clostridiales_DB27	Bacteria;Firmicutes
Bacteria_Firmicutes_Clostridia_Clostridiales_Defluviitaleaceae_Defluviitalea	Bacteria;Firmicutes
Bacteria_Firmicutes_Clostridia_Clostridiales_Defluviitaleaceae_Defluviitaleaceae_UCG-011	Bacteria;Firmicutes
Bacteria_Firmicutes_Clostridia_Clostridiales_ecb10	Bacteria;Firmicutes
Bacteria_Firmicutes_Clostridia_Clostridiales_Eubacteriaceae_Acetobacterium	Bacteria;Firmicutes
Bacteria_Firmicutes_Clostridia_Clostridiales_Eubacteriaceae_Alkalibacter	Bacteria;Firmicutes
Bacteria_Firmicutes_Clostridia_Clostridiales_Eubacteriaceae_Alkalibaculum	Bacteria;Firmicutes
Bacteria_Firmicutes_Clostridia_Clostridiales_Eubacteriaceae_Anaerofustis	Bacteria;Firmicutes
Bacteria_Firmicutes_Clostridia_Clostridiales_Eubacteriaceae_Eubacterium	Bacteria;Firmicutes
Bacteria_Firmicutes_Clostridia_Clostridiales_Eubacteriaceae_Garciella	Bacteria;Firmicutes
Bacteria_Firmicutes_Clostridia_Clostridiales_Eubacteriaceae_Pseudoramibacter	Bacteria;Firmicutes
Bacteria_Firmicutes_Clostridia_Clostridiales_Eubacteriaceae_uncultured	Bacteria;Firmicutes
Bacteria_Firmicutes_Clostridia_Clostridiales_Family_XI	Bacteria;Firmicutes
Bacteria_Firmicutes_Clostridia_Clostridiales_Family_XII_Acidaminobacter	Bacteria;Firmicutes
Bacteria_Firmicutes_Clostridia_Clostridiales_Family_XII_Fusibacter	Bacteria;Firmicutes
Bacteria_Firmicutes_Clostridia_Clostridiales_Family_XII_Guggenheimella	Bacteria;Firmicutes
Bacteria_Firmicutes_Clostridia_Clostridiales_Family_XII_uncultured	Bacteria;Firmicutes
Bacteria_Firmicutes_Clostridia_Clostridiales_Family_XIII__Eubacterium__brachy_group	Bacteria;Firmicutes
Bacteria_Firmicutes_Clostridia_Clostridiales_Family_XIII__Eubacterium__nodatum_group	Bacteria;Firmicutes
Bacteria_Firmicutes_Clostridia_Clostridiales_Family_XIII_Anaerovorax	Bacteria;Firmicutes
Bacteria_Firmicutes_Clostridia_Clostridiales_Family_XIII_Family_XIII_AD3011_group	Bacteria;Firmicutes
Bacteria_Firmicutes_Clostridia_Clostridiales_Family_XIII_Family_XIII_UCG-001	Bacteria;Firmicutes
Bacteria_Firmicutes_Clostridia_Clostridiales_Family_XIII_Family_XIII_UCG-002	Bacteria;Firmicutes
Bacteria_Firmicutes_Clostridia_Clostridiales_Family_XIII_Incertae_Sedis	Bacteria;Firmicutes
Bacteria_Firmicutes_Clostridia_Clostridiales_Family_XIII_Mogibacterium	Bacteria;Firmicutes
Bacteria_Firmicutes_Clostridia_Clostridiales_Family_XIII_uncultured	Bacteria;Firmicutes
Bacteria_Firmicutes_Clostridia_Clostridiales_Family_XIV	Bacteria;Firmicutes
Bacteria_Firmicutes_Clostridia_Clostridiales_Family_XVI_Carboxydocella	Bacteria;Firmicutes
Bacteria_Firmicutes_Clostridia_Clostridiales_Family_XVII_Sulfobacillus	Bacteria;Firmicutes
Bacteria_Firmicutes_Clostridia_Clostridiales_Family_XVII_Thermaerobacter	Bacteria;Firmicutes
Bacteria_Firmicutes_Clostridia_Clostridiales_Family_XVII_uncultured	Bacteria;Firmicutes
Bacteria_Firmicutes_Clostridia_Clostridiales_Family_XVIII	Bacteria;Firmicutes
Bacteria_Firmicutes_Clostridia_Clostridiales_GoM-GC232-4463-Bac1	Bacteria;Firmicutes
Bacteria_Firmicutes_Clostridia_Clostridiales_Gracilibacteraceae_Gracilibacter	Bacteria;Firmicutes
Bacteria_Firmicutes_Clostridia_Clostridiales_Gracilibacteraceae_Lutispora	Bacteria;Firmicutes
Bacteria_Firmicutes_Clostridia_Clostridiales_Gracilibacteraceae_uncultured	Bacteria;Firmicutes
Bacteria_Firmicutes_Clostridia_Clostridiales_Heliobacteriaceae_Heliobacillus	Bacteria;Firmicutes
Bacteria_Firmicutes_Clostridia_Clostridiales_Heliobacteriaceae_Heliobacterium	Bacteria;Firmicutes
Bacteria_Firmicutes_Clostridia_Clostridiales_Heliobacteriaceae_Heliophilum	Bacteria;Firmicutes
Bacteria_Firmicutes_Clostridia_Clostridiales_Heliobacteriaceae_Heliorestis	Bacteria;Firmicutes
Bacteria_Firmicutes_Clostridia_Clostridiales_Heliobacteriaceae_uncultured	Bacteria;Firmicutes
Bacteria_Firmicutes_Clostridia_Clostridiales_JTB215	Bacteria;Firmicutes
Bacteria_Firmicutes_Clostridia_Clostridiales_Kazan-2B-17	Bacteria;Firmicutes
Bacteria_Firmicutes_Clostridia_Clostridiales_Lachnospiraceae__Eubacterium__cellulosolvens_group	Bacteria;Firmicutes
Bacteria_Firmicutes_Clostridia_Clostridiales_Lachnospiraceae__Eubacterium__hallii_group	Bacteria;Firmicutes
Bacteria_Firmicutes_Clostridia_Clostridiales_Lachnospiraceae__Eubacterium__oxidoreducens_group	Bacteria;Firmicutes
Bacteria_Firmicutes_Clostridia_Clostridiales_Lachnospiraceae__Eubacterium__ruminantium_group	Bacteria;Firmicutes
Bacteria_Firmicutes_Clostridia_Clostridiales_Lachnospiraceae__Eubacterium__ventriosum_group	Bacteria;Firmicutes
Bacteria_Firmicutes_Clostridia_Clostridiales_Lachnospiraceae__Ruminococcus__gauvreauii_group	Bacteria;Firmicutes
Bacteria_Firmicutes_Clostridia_Clostridiales_Lachnospiraceae_Acetatifactor	Bacteria;Firmicutes
Bacteria_Firmicutes_Clostridia_Clostridiales_Lachnospiraceae_Acetitomaculum	Bacteria;Firmicutes
Bacteria_Firmicutes_Clostridia_Clostridiales_Lachnospiraceae_Anaerosporobacter	Bacteria;Firmicutes
Bacteria_Firmicutes_Clostridia_Clostridiales_Lachnospiraceae_Anaerostipes	Bacteria;Firmicutes
Bacteria_Firmicutes_Clostridia_Clostridiales_Lachnospiraceae_Blautia	Bacteria;Firmicutes
Bacteria_Firmicutes_Clostridia_Clostridiales_Lachnospiraceae_Butyrivibrio	Bacteria;Firmicutes
Bacteria_Firmicutes_Clostridia_Clostridiales_Lachnospiraceae_Butyrivibrio_2	Bacteria;Firmicutes
Bacteria_Firmicutes_Clostridia_Clostridiales_Lachnospiraceae_Catonella	Bacteria;Firmicutes
Bacteria_Firmicutes_Clostridia_Clostridiales_Lachnospiraceae_Cellulosilyticum	Bacteria;Firmicutes
Bacteria_Firmicutes_Clostridia_Clostridiales_Lachnospiraceae_Coprococcus_1	Bacteria;Firmicutes
Bacteria_Firmicutes_Clostridia_Clostridiales_Lachnospiraceae_Coprococcus_2	Bacteria;Firmicutes
Bacteria_Firmicutes_Clostridia_Clostridiales_Lachnospiraceae_Coprococcus_3	Bacteria;Firmicutes
Bacteria_Firmicutes_Clostridia_Clostridiales_Lachnospiraceae_Dorea	Bacteria;Firmicutes
Bacteria_Firmicutes_Clostridia_Clostridiales_Lachnospiraceae_Eisenbergiella	Bacteria;Firmicutes
Bacteria_Firmicutes_Clostridia_Clostridiales_Lachnospiraceae_Epulopiscium	Bacteria;Firmicutes
Bacteria_Firmicutes_Clostridia_Clostridiales_Lachnospiraceae_Fusicatenibacter	Bacteria;Firmicutes
Bacteria_Firmicutes_Clostridia_Clostridiales_Lachnospiraceae_Hespellia	Bacteria;Firmicutes
Bacteria_Firmicutes_Clostridia_Clostridiales_Lachnospiraceae_Howardella	Bacteria;Firmicutes
Bacteria_Firmicutes_Clostridia_Clostridiales_Lachnospiraceae_Hungatella	Bacteria;Firmicutes
Bacteria_Firmicutes_Clostridia_Clostridiales_Lachnospiraceae_Incertae_Sedis	Bacteria;Firmicutes
Bacteria_Firmicutes_Clostridia_Clostridiales_Lachnospiraceae_Johnsonella	Bacteria;Firmicutes
Bacteria_Firmicutes_Clostridia_Clostridiales_Lachnospiraceae_Lachnoanaerobaculum	Bacteria;Firmicutes
Bacteria_Firmicutes_Clostridia_Clostridiales_Lachnospiraceae_Lachnobacterium	Bacteria;Firmicutes
Bacteria_Firmicutes_Clostridia_Clostridiales_Lachnospiraceae_Lachnoclostridium	Bacteria;Firmicutes
Bacteria_Firmicutes_Clostridia_Clostridiales_Lachnospiraceae_Lachnoclostridium_1	Bacteria;Firmicutes
Bacteria_Firmicutes_Clostridia_Clostridiales_Lachnospiraceae_Lachnoclostridium_10	Bacteria;Firmicutes
Bacteria_Firmicutes_Clostridia_Clostridiales_Lachnospiraceae_Lachnoclostridium_12	Bacteria;Firmicutes
Bacteria_Firmicutes_Clostridia_Clostridiales_Lachnospiraceae_Lachnoclostridium_5	Bacteria;Firmicutes
Bacteria_Firmicutes_Clostridia_Clostridiales_Lachnospiraceae_Lachnospira	Bacteria;Firmicutes
Bacteria_Firmicutes_Clostridia_Clostridiales_Lachnospiraceae_Lachnospiraceae_AC2044_group	Bacteria;Firmicutes
Bacteria_Firmicutes_Clostridia_Clostridiales_Lachnospiraceae_Lachnospiraceae_FCS020_group	Bacteria;Firmicutes
Bacteria_Firmicutes_Clostridia_Clostridiales_Lachnospiraceae_Lachnospiraceae_FE2018_group	Bacteria;Firmicutes
Bacteria_Firmicutes_Clostridia_Clostridiales_Lachnospiraceae_Lachnospiraceae_NC2004_group	Bacteria;Firmicutes
Bacteria_Firmicutes_Clostridia_Clostridiales_Lachnospiraceae_Lachnospiraceae_ND3007_group	Bacteria;Firmicutes
Bacteria_Firmicutes_Clostridia_Clostridiales_Lachnospiraceae_Lachnospiraceae_NK3A20_group	Bacteria;Firmicutes
Bacteria_Firmicutes_Clostridia_Clostridiales_Lachnospiraceae_Lachnospiraceae_NK4A136_group	Bacteria;Firmicutes
Bacteria_Firmicutes_Clostridia_Clostridiales_Lachnospiraceae_Lachnospiraceae_NK4B4_group	Bacteria;Firmicutes
Bacteria_Firmicutes_Clostridia_Clostridiales_Lachnospiraceae_Lachnospiraceae_UCG-001	Bacteria;Firmicutes
Bacteria_Firmicutes_Clostridia_Clostridiales_Lachnospiraceae_Lachnospiraceae_UCG-002	Bacteria;Firmicutes
Bacteria_Firmicutes_Clostridia_Clostridiales_Lachnospiraceae_Lachnospiraceae_UCG-003	Bacteria;Firmicutes
Bacteria_Firmicutes_Clostridia_Clostridiales_Lachnospiraceae_Lachnospiraceae_UCG-004	Bacteria;Firmicutes
Bacteria_Firmicutes_Clostridia_Clostridiales_Lachnospiraceae_Lachnospiraceae_UCG-005	Bacteria;Firmicutes
Bacteria_Firmicutes_Clostridia_Clostridiales_Lachnospiraceae_Lachnospiraceae_UCG-006	Bacteria;Firmicutes
Bacteria_Firmicutes_Clostridia_Clostridiales_Lachnospiraceae_Lachnospiraceae_UCG-007	Bacteria;Firmicutes
Bacteria_Firmicutes_Clostridia_Clostridiales_Lachnospiraceae_Lachnospiraceae_UCG-008	Bacteria;Firmicutes
Bacteria_Firmicutes_Clostridia_Clostridiales_Lachnospiraceae_Lachnospiraceae_UCG-009	Bacteria;Firmicutes
Bacteria_Firmicutes_Clostridia_Clostridiales_Lachnospiraceae_Lachnospiraceae_UCG-010	Bacteria;Firmicutes
Bacteria_Firmicutes_Clostridia_Clostridiales_Lachnospiraceae_Lachnospiraceae_XPB1014_group	Bacteria;Firmicutes
Bacteria_Firmicutes_Clostridia_Clostridiales_Lachnospiraceae_Lactonifactor	Bacteria;Firmicutes
Bacteria_Firmicutes_Clostridia_Clostridiales_Lachnospiraceae_Marvinbryantia	Bacteria;Firmicutes
Bacteria_Firmicutes_Clostridia_Clostridiales_Lachnospiraceae_Mobilitalea	Bacteria;Firmicutes
Bacteria_Firmicutes_Clostridia_Clostridiales_Lachnospiraceae_Moryella	Bacteria;Firmicutes
Bacteria_Firmicutes_Clostridia_Clostridiales_Lachnospiraceae_Natranaerovirga	Bacteria;Firmicutes
Bacteria_Firmicutes_Clostridia_Clostridiales_Lachnospiraceae_Oribacterium	Bacteria;Firmicutes
Bacteria_Firmicutes_Clostridia_Clostridiales_Lachnospiraceae_Parasporobacterium	Bacteria;Firmicutes
Bacteria_Firmicutes_Clostridia_Clostridiales_Lachnospiraceae_possible_genus_Sk003-Sk004	Bacteria;Firmicutes
Bacteria_Firmicutes_Clostridia_Clostridiales_Lachnospiraceae_possible_genus_Sk018	Bacteria;Firmicutes
Bacteria_Firmicutes_Clostridia_Clostridiales_Lachnospiraceae_probable_genus_10	Bacteria;Firmicutes
Bacteria_Firmicutes_Clostridia_Clostridiales_Lachnospiraceae_Pseudobutyrivibrio	Bacteria;Firmicutes
Bacteria_Firmicutes_Clostridia_Clostridiales_Lachnospiraceae_Robinsoniella	Bacteria;Firmicutes
Bacteria_Firmicutes_Clostridia_Clostridiales_Lachnospiraceae_Roseburia	Bacteria;Firmicutes
Bacteria_Firmicutes_Clostridia_Clostridiales_Lachnospiraceae_Shuttleworthia	Bacteria;Firmicutes
Bacteria_Firmicutes_Clostridia_Clostridiales_Lachnospiraceae_Sporobacterium	Bacteria;Firmicutes
Bacteria_Firmicutes_Clostridia_Clostridiales_Lachnospiraceae_Stomatobaculum	Bacteria;Firmicutes
Bacteria_Firmicutes_Clostridia_Clostridiales_Lachnospiraceae_Syntrophococcus	Bacteria;Firmicutes
Bacteria_Firmicutes_Clostridia_Clostridiales_Lachnospiraceae_Tyzzerella	Bacteria;Firmicutes
Bacteria_Firmicutes_Clostridia_Clostridiales_Lachnospiraceae_Tyzzerella_3	Bacteria;Firmicutes
Bacteria_Firmicutes_Clostridia_Clostridiales_Lachnospiraceae_Tyzzerella_4	Bacteria;Firmicutes
Bacteria_Firmicutes_Clostridia_Clostridiales_Lachnospiraceae_uncultured	Bacteria;Firmicutes
Bacteria_Firmicutes_Clostridia_Clostridiales_Lachnospiraceae_Vallitalea	Bacteria;Firmicutes
Bacteria_Firmicutes_Clostridia_Clostridiales_livecontrolB21	Bacteria;Firmicutes
Bacteria_Firmicutes_Clostridia_Clostridiales_MAT-CR-H4-C10	Bacteria;Firmicutes
Bacteria_Firmicutes_Clostridia_Clostridiales_P._palm_C-A_51	Bacteria;Firmicutes
Bacteria_Firmicutes_Clostridia_Clostridiales_Peptococcaceae_Cryptanaerobacter	Bacteria;Firmicutes
Bacteria_Firmicutes_Clostridia_Clostridiales_Peptococcaceae_Dehalobacter	Bacteria;Firmicutes
Bacteria_Firmicutes_Clostridia_Clostridiales_Peptococcaceae_Dehalobacterium	Bacteria;Firmicutes
Bacteria_Firmicutes_Clostridia_Clostridiales_Peptococcaceae_Desulfitibacter	Bacteria;Firmicutes
Bacteria_Firmicutes_Clostridia_Clostridiales_Peptococcaceae_Desulfitispora	Bacteria;Firmicutes
Bacteria_Firmicutes_Clostridia_Clostridiales_Peptococcaceae_Desulfitobacterium	Bacteria;Firmicutes
Bacteria_Firmicutes_Clostridia_Clostridiales_Peptococcaceae_Desulfonispora	Bacteria;Firmicutes
Bacteria_Firmicutes_Clostridia_Clostridiales_Peptococcaceae_Desulfosporosinus	Bacteria;Firmicutes
Bacteria_Firmicutes_Clostridia_Clostridiales_Peptococcaceae_Desulfotomaculum	Bacteria;Firmicutes
Bacteria_Firmicutes_Clostridia_Clostridiales_Peptococcaceae_Desulfovirgula	Bacteria;Firmicutes
Bacteria_Firmicutes_Clostridia_Clostridiales_Peptococcaceae_Desulfurispora	Bacteria;Firmicutes
Bacteria_Firmicutes_Clostridia_Clostridiales_Peptococcaceae_Pelotomaculum	Bacteria;Firmicutes
Bacteria_Firmicutes_Clostridia_Clostridiales_Peptococcaceae_Peptococcus	Bacteria;Firmicutes
Bacteria_Firmicutes_Clostridia_Clostridiales_Peptococcaceae_Sporotomaculum	Bacteria;Firmicutes
Bacteria_Firmicutes_Clostridia_Clostridiales_Peptococcaceae_Syntrophobotulus	Bacteria;Firmicutes
Bacteria_Firmicutes_Clostridia_Clostridiales_Peptococcaceae_Thermincola	Bacteria;Firmicutes
Bacteria_Firmicutes_Clostridia_Clostridiales_Peptococcaceae_uncultured	Bacteria;Firmicutes
Bacteria_Firmicutes_Clostridia_Clostridiales_Peptostreptococcaceae	Bacteria;Firmicutes
Bacteria_Firmicutes_Clostridia_Clostridiales_Ruminococcaceae__Eubacterium__coprostanoligenes_group	Bacteria;Firmicutes
Bacteria_Firmicutes_Clostridia_Clostridiales_Ruminococcaceae_Acetanaerobacterium	Bacteria;Firmicutes
Bacteria_Firmicutes_Clostridia_Clostridiales_Ruminococcaceae_Acetivibrio	Bacteria;Firmicutes
Bacteria_Firmicutes_Clostridia_Clostridiales_Ruminococcaceae_Anaerobacterium	Bacteria;Firmicutes
Bacteria_Firmicutes_Clostridia_Clostridiales_Ruminococcaceae_Anaerofilum	Bacteria;Firmicutes
Bacteria_Firmicutes_Clostridia_Clostridiales_Ruminococcaceae_Anaerotruncus	Bacteria;Firmicutes
Bacteria_Firmicutes_Clostridia_Clostridiales_Ruminococcaceae_Butyricicoccus	Bacteria;Firmicutes
Bacteria_Firmicutes_Clostridia_Clostridiales_Ruminococcaceae_Candidatus_Soleaferrea	Bacteria;Firmicutes
Bacteria_Firmicutes_Clostridia_Clostridiales_Ruminococcaceae_Cellulosibacter	Bacteria;Firmicutes
Bacteria_Firmicutes_Clostridia_Clostridiales_Ruminococcaceae_Ethanoligenens	Bacteria;Firmicutes
Bacteria_Firmicutes_Clostridia_Clostridiales_Ruminococcaceae_Faecalibacterium	Bacteria;Firmicutes
Bacteria_Firmicutes_Clostridia_Clostridiales_Ruminococcaceae_Fastidiosipila	Bacteria;Firmicutes
Bacteria_Firmicutes_Clostridia_Clostridiales_Ruminococcaceae_Flavonifractor	Bacteria;Firmicutes
Bacteria_Firmicutes_Clostridia_Clostridiales_Ruminococcaceae_Hydrogenoanaerobacterium	Bacteria;Firmicutes
Bacteria_Firmicutes_Clostridia_Clostridiales_Ruminococcaceae_Intestinimonas	Bacteria;Firmicutes
Bacteria_Firmicutes_Clostridia_Clostridiales_Ruminococcaceae_Oscillibacter	Bacteria;Firmicutes
Bacteria_Firmicutes_Clostridia_Clostridiales_Ruminococcaceae_Oscillospira	Bacteria;Firmicutes
Bacteria_Firmicutes_Clostridia_Clostridiales_Ruminococcaceae_Papillibacter	Bacteria;Firmicutes
Bacteria_Firmicutes_Clostridia_Clostridiales_Ruminococcaceae_Pseudobacteroides	Bacteria;Firmicutes
Bacteria_Firmicutes_Clostridia_Clostridiales_Ruminococcaceae_Pseudoflavonifractor	Bacteria;Firmicutes
Bacteria_Firmicutes_Clostridia_Clostridiales_Ruminococcaceae_Ruminiclostridium	Bacteria;Firmicutes
Bacteria_Firmicutes_Clostridia_Clostridiales_Ruminococcaceae_Ruminiclostridium_1	Bacteria;Firmicutes
Bacteria_Firmicutes_Clostridia_Clostridiales_Ruminococcaceae_Ruminiclostridium_5	Bacteria;Firmicutes
Bacteria_Firmicutes_Clostridia_Clostridiales_Ruminococcaceae_Ruminiclostridium_6	Bacteria;Firmicutes
Bacteria_Firmicutes_Clostridia_Clostridiales_Ruminococcaceae_Ruminiclostridium_9	Bacteria;Firmicutes
Bacteria_Firmicutes_Clostridia_Clostridiales_Ruminococcaceae_Ruminococcaceae_NK4A214_group	Bacteria;Firmicutes
Bacteria_Firmicutes_Clostridia_Clostridiales_Ruminococcaceae_Ruminococcaceae_UCG-001	Bacteria;Firmicutes
Bacteria_Firmicutes_Clostridia_Clostridiales_Ruminococcaceae_Ruminococcaceae_UCG-002	Bacteria;Firmicutes
Bacteria_Firmicutes_Clostridia_Clostridiales_Ruminococcaceae_Ruminococcaceae_UCG-003	Bacteria;Firmicutes
Bacteria_Firmicutes_Clostridia_Clostridiales_Ruminococcaceae_Ruminococcaceae_UCG-004	Bacteria;Firmicutes
Bacteria_Firmicutes_Clostridia_Clostridiales_Ruminococcaceae_Ruminococcaceae_UCG-005	Bacteria;Firmicutes
Bacteria_Firmicutes_Clostridia_Clostridiales_Ruminococcaceae_Ruminococcaceae_UCG-007	Bacteria;Firmicutes
Bacteria_Firmicutes_Clostridia_Clostridiales_Ruminococcaceae_Ruminococcaceae_UCG-008	Bacteria;Firmicutes
Bacteria_Firmicutes_Clostridia_Clostridiales_Ruminococcaceae_Ruminococcaceae_UCG-009	Bacteria;Firmicutes
Bacteria_Firmicutes_Clostridia_Clostridiales_Ruminococcaceae_Ruminococcaceae_UCG-010	Bacteria;Firmicutes
Bacteria_Firmicutes_Clostridia_Clostridiales_Ruminococcaceae_Ruminococcaceae_UCG-011	Bacteria;Firmicutes
Bacteria_Firmicutes_Clostridia_Clostridiales_Ruminococcaceae_Ruminococcaceae_UCG-012	Bacteria;Firmicutes
Bacteria_Firmicutes_Clostridia_Clostridiales_Ruminococcaceae_Ruminococcaceae_UCG-013	Bacteria;Firmicutes
Bacteria_Firmicutes_Clostridia_Clostridiales_Ruminococcaceae_Ruminococcaceae_UCG-014	Bacteria;Firmicutes
Bacteria_Firmicutes_Clostridia_Clostridiales_Ruminococcaceae_Ruminococcaceae_V9D2013_group	Bacteria;Firmicutes
Bacteria_Firmicutes_Clostridia_Clostridiales_Ruminococcaceae_Ruminococcus_1	Bacteria;Firmicutes
Bacteria_Firmicutes_Clostridia_Clostridiales_Ruminococcaceae_Ruminococcus_2	Bacteria;Firmicutes
Bacteria_Firmicutes_Clostridia_Clostridiales_Ruminococcaceae_Saccharofermentans	Bacteria;Firmicutes
Bacteria_Firmicutes_Clostridia_Clostridiales_Ruminococcaceae_Sporobacter	Bacteria;Firmicutes
Bacteria_Firmicutes_Clostridia_Clostridiales_Ruminococcaceae_Subdoligranulum	Bacteria;Firmicutes
Bacteria_Firmicutes_Clostridia_Clostridiales_Ruminococcaceae_uncultured	Bacteria;Firmicutes
Bacteria_Firmicutes_Clostridia_Clostridiales_Syntrophomonadaceae_Candidatus_Contubernalis	Bacteria;Firmicutes
Bacteria_Firmicutes_Clostridia_Clostridiales_Syntrophomonadaceae_Dethiobacter	Bacteria;Firmicutes
Bacteria_Firmicutes_Clostridia_Clostridiales_Syntrophomonadaceae_Pelospora	Bacteria;Firmicutes
Bacteria_Firmicutes_Clostridia_Clostridiales_Syntrophomonadaceae_Syntrophomonas	Bacteria;Firmicutes
Bacteria_Firmicutes_Clostridia_Clostridiales_Syntrophomonadaceae_Syntrophothermus	Bacteria;Firmicutes
Bacteria_Firmicutes_Clostridia_Clostridiales_Syntrophomonadaceae_Thermosyntropha	Bacteria;Firmicutes
Bacteria_Firmicutes_Clostridia_Clostridiales_Syntrophomonadaceae_uncultured	Bacteria;Firmicutes
Bacteria_Firmicutes_Clostridia_Clostridiales_TSAC18	Bacteria;Firmicutes
Bacteria_Firmicutes_Clostridia_Clostridiales_TTA-B61	Bacteria;Firmicutes
Bacteria_Firmicutes_Clostridia_Clostridiales_uncultured	Bacteria;Firmicutes
Bacteria_Firmicutes_Clostridia_Clostridiales_YNPFFP2	Bacteria;Firmicutes
Bacteria_Firmicutes_Clostridia_D8A-2	Bacteria;Firmicutes
Bacteria_Firmicutes_Clostridia_Halanaerobiales_64K2	Bacteria;Firmicutes
Bacteria_Firmicutes_Clostridia_Halanaerobiales_Halanaerobiaceae	Bacteria;Firmicutes
Bacteria_Firmicutes_Clostridia_Halanaerobiales_Halobacteroidaceae_Acetohalobium	Bacteria;Firmicutes
Bacteria_Firmicutes_Clostridia_Halanaerobiales_Halobacteroidaceae_Fuchsiella	Bacteria;Firmicutes
Bacteria_Firmicutes_Clostridia_Halanaerobiales_Halobacteroidaceae_Halanaerobacter	Bacteria;Firmicutes
Bacteria_Firmicutes_Clostridia_Halanaerobiales_Halobacteroidaceae_Halanaerobaculum	Bacteria;Firmicutes
Bacteria_Firmicutes_Clostridia_Halanaerobiales_Halobacteroidaceae_Halobacteroides	Bacteria;Firmicutes
Bacteria_Firmicutes_Clostridia_Halanaerobiales_Halobacteroidaceae_Halonatronum	Bacteria;Firmicutes
Bacteria_Firmicutes_Clostridia_Halanaerobiales_Halobacteroidaceae_Natroniella	Bacteria;Firmicutes
Bacteria_Firmicutes_Clostridia_Halanaerobiales_Halobacteroidaceae_Orenia	Bacteria;Firmicutes
Bacteria_Firmicutes_Clostridia_Halanaerobiales_Halobacteroidaceae_Selenihalanaerobacter	Bacteria;Firmicutes
Bacteria_Firmicutes_Clostridia_Halanaerobiales_Halobacteroidaceae_Sporohalobacter	Bacteria;Firmicutes
Bacteria_Firmicutes_Clostridia_Halanaerobiales_Halobacteroidaceae_uncultured	Bacteria;Firmicutes
Bacteria_Firmicutes_Clostridia_Halanaerobiales_uncultured	Bacteria;Firmicutes
Bacteria_Firmicutes_Clostridia_Natranaerobiales_Natranaerobiaceae	Bacteria;Firmicutes
Bacteria_Firmicutes_Clostridia_NRB23	Bacteria;Firmicutes
Bacteria_Firmicutes_Clostridia_Thermoanaerobacterales_Family_III_Caldanaerovirga	Bacteria;Firmicutes
Bacteria_Firmicutes_Clostridia_Thermoanaerobacterales_Family_III_Caldicellulosiruptor	Bacteria;Firmicutes
Bacteria_Firmicutes_Clostridia_Thermoanaerobacterales_Family_III_Fervidicola	Bacteria;Firmicutes
Bacteria_Firmicutes_Clostridia_Thermoanaerobacterales_Family_III_Tepidanaerobacter	Bacteria;Firmicutes
Bacteria_Firmicutes_Clostridia_Thermoanaerobacterales_Family_III_Thermoanaerobacterium	Bacteria;Firmicutes
Bacteria_Firmicutes_Clostridia_Thermoanaerobacterales_Family_III_Thermosediminibacter	Bacteria;Firmicutes
Bacteria_Firmicutes_Clostridia_Thermoanaerobacterales_Family_III_Thermovenabulum	Bacteria;Firmicutes
Bacteria_Firmicutes_Clostridia_Thermoanaerobacterales_Family_III_Thermovorax	Bacteria;Firmicutes
Bacteria_Firmicutes_Clostridia_Thermoanaerobacterales_Family_IV_Mahella	Bacteria;Firmicutes
Bacteria_Firmicutes_Clostridia_Thermoanaerobacterales_Family_XVII_Candidatus_Fervidibacter	Bacteria;Firmicutes
Bacteria_Firmicutes_Clostridia_Thermoanaerobacterales_SRB2	Bacteria;Firmicutes
Bacteria_Firmicutes_Clostridia_Thermoanaerobacterales_Thermoanaerobacteraceae_Ammonifex	Bacteria;Firmicutes
Bacteria_Firmicutes_Clostridia_Thermoanaerobacterales_Thermoanaerobacteraceae_Caldanaerobacter	Bacteria;Firmicutes
Bacteria_Firmicutes_Clostridia_Thermoanaerobacterales_Thermoanaerobacteraceae_Caldanaerobius	Bacteria;Firmicutes
Bacteria_Firmicutes_Clostridia_Thermoanaerobacterales_Thermoanaerobacteraceae_Calderihabitans	Bacteria;Firmicutes
Bacteria_Firmicutes_Clostridia_Thermoanaerobacterales_Thermoanaerobacteraceae_Caloribacterium	Bacteria;Firmicutes
Bacteria_Firmicutes_Clostridia_Thermoanaerobacterales_Thermoanaerobacteraceae_Carboxydothermus	Bacteria;Firmicutes
Bacteria_Firmicutes_Clostridia_Thermoanaerobacterales_Thermoanaerobacteraceae_Gelria	Bacteria;Firmicutes
Bacteria_Firmicutes_Clostridia_Thermoanaerobacterales_Thermoanaerobacteraceae_Moorella	Bacteria;Firmicutes
Bacteria_Firmicutes_Clostridia_Thermoanaerobacterales_Thermoanaerobacteraceae_Syntrophaceticus	Bacteria;Firmicutes
Bacteria_Firmicutes_Clostridia_Thermoanaerobacterales_Thermoanaerobacteraceae_Thermacetogenium	Bacteria;Firmicutes
Bacteria_Firmicutes_Clostridia_Thermoanaerobacterales_Thermoanaerobacteraceae_Thermanaeromonas	Bacteria;Firmicutes
Bacteria_Firmicutes_Clostridia_Thermoanaerobacterales_Thermoanaerobacteraceae_Thermoanaerobacter	Bacteria;Firmicutes
Bacteria_Firmicutes_Clostridia_Thermoanaerobacterales_Thermoanaerobacteraceae_uncultured	Bacteria;Firmicutes
Bacteria_Firmicutes_Clostridia_Thermoanaerobacterales_Thermodesulfobiaceae_Coprothermobacter	Bacteria;Firmicutes
Bacteria_Firmicutes_Clostridia_Thermoanaerobacterales_Thermodesulfobiaceae_Thermodesulfobium	Bacteria;Firmicutes
Bacteria_Firmicutes_Clostridia_Thermolithobacterales_Thermolithobacteraceae_Thermolithobacter	Bacteria;Firmicutes
Bacteria_Firmicutes_Erysipelotrichia_Erysipelotrichales_Erysipelotrichaceae__Anaerorhabdus__furcosa_group	Bacteria;Firmicutes
Bacteria_Firmicutes_Erysipelotrichia_Erysipelotrichales_Erysipelotrichaceae_Allobaculum	Bacteria;Firmicutes
Bacteria_Firmicutes_Erysipelotrichia_Erysipelotrichales_Erysipelotrichaceae_Asteroleplasma	Bacteria;Firmicutes
Bacteria_Firmicutes_Erysipelotrichia_Erysipelotrichales_Erysipelotrichaceae_Bulleidia	Bacteria;Firmicutes
Bacteria_Firmicutes_Erysipelotrichia_Erysipelotrichales_Erysipelotrichaceae_Candidatus_Stoquefichus	Bacteria;Firmicutes
Bacteria_Firmicutes_Erysipelotrichia_Erysipelotrichales_Erysipelotrichaceae_Catenibacterium	Bacteria;Firmicutes
Bacteria_Firmicutes_Erysipelotrichia_Erysipelotrichales_Erysipelotrichaceae_Coprobacillus	Bacteria;Firmicutes
Bacteria_Firmicutes_Erysipelotrichia_Erysipelotrichales_Erysipelotrichaceae_Dielma	Bacteria;Firmicutes
Bacteria_Firmicutes_Erysipelotrichia_Erysipelotrichales_Erysipelotrichaceae_Eggerthia	Bacteria;Firmicutes
Bacteria_Firmicutes_Erysipelotrichia_Erysipelotrichales_Erysipelotrichaceae_Erysipelatoclostridium	Bacteria;Firmicutes
Bacteria_Firmicutes_Erysipelotrichia_Erysipelotrichales_Erysipelotrichaceae_Erysipelothrix	Bacteria;Firmicutes
Bacteria_Firmicutes_Erysipelotrichia_Erysipelotrichales_Erysipelotrichaceae_Erysipelotrichaceae_UCG-001	Bacteria;Firmicutes
Bacteria_Firmicutes_Erysipelotrichia_Erysipelotrichales_Erysipelotrichaceae_Erysipelotrichaceae_UCG-002	Bacteria;Firmicutes
Bacteria_Firmicutes_Erysipelotrichia_Erysipelotrichales_Erysipelotrichaceae_Erysipelotrichaceae_UCG-003	Bacteria;Firmicutes
Bacteria_Firmicutes_Erysipelotrichia_Erysipelotrichales_Erysipelotrichaceae_Erysipelotrichaceae_UCG-004	Bacteria;Firmicutes
Bacteria_Firmicutes_Erysipelotrichia_Erysipelotrichales_Erysipelotrichaceae_Erysipelotrichaceae_UCG-006	Bacteria;Firmicutes
Bacteria_Firmicutes_Erysipelotrichia_Erysipelotrichales_Erysipelotrichaceae_Erysipelotrichaceae_UCG-007	Bacteria;Firmicutes
Bacteria_Firmicutes_Erysipelotrichia_Erysipelotrichales_Erysipelotrichaceae_Erysipelotrichaceae_UCG-008	Bacteria;Firmicutes
Bacteria_Firmicutes_Erysipelotrichia_Erysipelotrichales_Erysipelotrichaceae_Erysipelotrichaceae_UCG-009	Bacteria;Firmicutes
Bacteria_Firmicutes_Erysipelotrichia_Erysipelotrichales_Erysipelotrichaceae_Erysipelotrichaceae_UCG-010	Bacteria;Firmicutes
Bacteria_Firmicutes_Erysipelotrichia_Erysipelotrichales_Erysipelotrichaceae_Faecalicoccus	Bacteria;Firmicutes
Bacteria_Firmicutes_Erysipelotrichia_Erysipelotrichales_Erysipelotrichaceae_Faecalitalea	Bacteria;Firmicutes
Bacteria_Firmicutes_Erysipelotrichia_Erysipelotrichales_Erysipelotrichaceae_Holdemanella	Bacteria;Firmicutes
Bacteria_Firmicutes_Erysipelotrichia_Erysipelotrichales_Erysipelotrichaceae_Holdemania	Bacteria;Firmicutes
Bacteria_Firmicutes_Erysipelotrichia_Erysipelotrichales_Erysipelotrichaceae_Incertae_Sedis	Bacteria;Firmicutes
Bacteria_Firmicutes_Erysipelotrichia_Erysipelotrichales_Erysipelotrichaceae_Kandleria	Bacteria;Firmicutes
Bacteria_Firmicutes_Erysipelotrichia_Erysipelotrichales_Erysipelotrichaceae_Sharpea	Bacteria;Firmicutes
Bacteria_Firmicutes_Erysipelotrichia_Erysipelotrichales_Erysipelotrichaceae_Solobacterium	Bacteria;Firmicutes
Bacteria_Firmicutes_Erysipelotrichia_Erysipelotrichales_Erysipelotrichaceae_Turicibacter	Bacteria;Firmicutes
Bacteria_Firmicutes_Erysipelotrichia_Erysipelotrichales_Erysipelotrichaceae_uncultured	Bacteria;Firmicutes
Bacteria_Firmicutes_Negativicutes_Selenomonadales_Acidaminococcaceae_Acidaminococcus	Bacteria;Firmicutes
Bacteria_Firmicutes_Negativicutes_Selenomonadales_Acidaminococcaceae_Phascolarctobacterium	Bacteria;Firmicutes
Bacteria_Firmicutes_Negativicutes_Selenomonadales_Acidaminococcaceae_Succiniclasticum	Bacteria;Firmicutes
Bacteria_Firmicutes_Negativicutes_Selenomonadales_Acidaminococcaceae_Succinispira	Bacteria;Firmicutes
Bacteria_Firmicutes_Negativicutes_Selenomonadales_Acidaminococcaceae_uncultured	Bacteria;Firmicutes
Bacteria_Firmicutes_Negativicutes_Selenomonadales_uncultured	Bacteria;Firmicutes
Bacteria_Firmicutes_Negativicutes_Selenomonadales_Veillonellaceae_Acetonema	Bacteria;Firmicutes
Bacteria_Firmicutes_Negativicutes_Selenomonadales_Veillonellaceae_Allisonella	Bacteria;Firmicutes
Bacteria_Firmicutes_Negativicutes_Selenomonadales_Veillonellaceae_Anaeroarcus	Bacteria;Firmicutes
Bacteria_Firmicutes_Negativicutes_Selenomonadales_Veillonellaceae_Anaeroglobus	Bacteria;Firmicutes
Bacteria_Firmicutes_Negativicutes_Selenomonadales_Veillonellaceae_Anaeromusa	Bacteria;Firmicutes
Bacteria_Firmicutes_Negativicutes_Selenomonadales_Veillonellaceae_Anaerosinus	Bacteria;Firmicutes
Bacteria_Firmicutes_Negativicutes_Selenomonadales_Veillonellaceae_Anaerospora	Bacteria;Firmicutes
Bacteria_Firmicutes_Negativicutes_Selenomonadales_Veillonellaceae_Anaerovibrio	Bacteria;Firmicutes
Bacteria_Firmicutes_Negativicutes_Selenomonadales_Veillonellaceae_Centipeda	Bacteria;Firmicutes
Bacteria_Firmicutes_Negativicutes_Selenomonadales_Veillonellaceae_Dendrosporobacter	Bacteria;Firmicutes
Bacteria_Firmicutes_Negativicutes_Selenomonadales_Veillonellaceae_Dialister	Bacteria;Firmicutes
Bacteria_Firmicutes_Negativicutes_Selenomonadales_Veillonellaceae_Megamonas	Bacteria;Firmicutes
Bacteria_Firmicutes_Negativicutes_Selenomonadales_Veillonellaceae_Megasphaera	Bacteria;Firmicutes
Bacteria_Firmicutes_Negativicutes_Selenomonadales_Veillonellaceae_Mitsuokella	Bacteria;Firmicutes
Bacteria_Firmicutes_Negativicutes_Selenomonadales_Veillonellaceae_Negativicoccus	Bacteria;Firmicutes
Bacteria_Firmicutes_Negativicutes_Selenomonadales_Veillonellaceae_Pectinatus	Bacteria;Firmicutes
Bacteria_Firmicutes_Negativicutes_Selenomonadales_Veillonellaceae_Pelosinus	Bacteria;Firmicutes
Bacteria_Firmicutes_Negativicutes_Selenomonadales_Veillonellaceae_Propionispira	Bacteria;Firmicutes
Bacteria_Firmicutes_Negativicutes_Selenomonadales_Veillonellaceae_Propionispora	Bacteria;Firmicutes
Bacteria_Firmicutes_Negativicutes_Selenomonadales_Veillonellaceae_Quinella	Bacteria;Firmicutes
Bacteria_Firmicutes_Negativicutes_Selenomonadales_Veillonellaceae_Schwartzia	Bacteria;Firmicutes
Bacteria_Firmicutes_Negativicutes_Selenomonadales_Veillonellaceae_Selenomonas	Bacteria;Firmicutes
Bacteria_Firmicutes_Negativicutes_Selenomonadales_Veillonellaceae_Selenomonas_1	Bacteria;Firmicutes
Bacteria_Firmicutes_Negativicutes_Selenomonadales_Veillonellaceae_Selenomonas_3	Bacteria;Firmicutes
Bacteria_Firmicutes_Negativicutes_Selenomonadales_Veillonellaceae_Selenomonas_4	Bacteria;Firmicutes
Bacteria_Firmicutes_Negativicutes_Selenomonadales_Veillonellaceae_Sporolituus	Bacteria;Firmicutes
Bacteria_Firmicutes_Negativicutes_Selenomonadales_Veillonellaceae_Sporomusa	Bacteria;Firmicutes
Bacteria_Firmicutes_Negativicutes_Selenomonadales_Veillonellaceae_Thermosinus	Bacteria;Firmicutes
Bacteria_Firmicutes_Negativicutes_Selenomonadales_Veillonellaceae_uncultured	Bacteria;Firmicutes
Bacteria_Firmicutes_Negativicutes_Selenomonadales_Veillonellaceae_Veillonella	Bacteria;Firmicutes
Bacteria_Firmicutes_Negativicutes_Selenomonadales_Veillonellaceae_Veillonellaceae_UCG-001	Bacteria;Firmicutes
Bacteria_Firmicutes_Negativicutes_Selenomonadales_Veillonellaceae_Zymophilus	Bacteria;Firmicutes
Bacteria_Firmicutes_OPB54	Bacteria;Firmicutes
Bacteria_Fusobacteria_Fusobacteriia_Fusobacteriales_ASCC02	Bacteria;Others
Bacteria_Fusobacteria_Fusobacteriia_Fusobacteriales_boneC3G7	Bacteria;Others
Bacteria_Fusobacteria_Fusobacteriia_Fusobacteriales_CFT112H7	Bacteria;Others
Bacteria_Fusobacteria_Fusobacteriia_Fusobacteriales_Fusobacteriaceae	Bacteria;Others
Bacteria_Fusobacteria_Fusobacteriia_Fusobacteriales_Hados.Sed.Eubac.3	Bacteria;Others
Bacteria_Fusobacteria_Fusobacteriia_Fusobacteriales_Leptotrichiaceae_Leptotrichia	Bacteria;Others
Bacteria_Fusobacteria_Fusobacteriia_Fusobacteriales_Leptotrichiaceae_Sebaldella	Bacteria;Others
Bacteria_Fusobacteria_Fusobacteriia_Fusobacteriales_Leptotrichiaceae_Sneathia	Bacteria;Others
Bacteria_Fusobacteria_Fusobacteriia_Fusobacteriales_Leptotrichiaceae_Streptobacillus	Bacteria;Others
Bacteria_Fusobacteria_Fusobacteriia_Fusobacteriales_Leptotrichiaceae_uncultured	Bacteria;Others
Bacteria_GAL08	Bacteria;Others
Bacteria_Gemmatimonadetes_Gemmatimonadetes_AT425-EubC11_terrestrial_group	Bacteria;Others
Bacteria_Gemmatimonadetes_Gemmatimonadetes_BD2-11_terrestrial_group	Bacteria;Others
Bacteria_Gemmatimonadetes_Gemmatimonadetes_Gemmatimonadales_Gemmatimonadaceae_Gemmatimonas	Bacteria;Others
Bacteria_Gemmatimonadetes_Gemmatimonadetes_Gemmatimonadales_Gemmatimonadaceae_uncultured	Bacteria;Others
Bacteria_Gemmatimonadetes_Gemmatimonadetes_Kazan-1B-37	Bacteria;Others
Bacteria_Gemmatimonadetes_Gemmatimonadetes_PAUC43f_marine_benthic_group	Bacteria;Others
Bacteria_Gemmatimonadetes_Gemmatimonadetes_S0134_terrestrial_group	Bacteria;Others
Bacteria_GOUTA4	Bacteria;Others
Bacteria_Gracilibacteria	Bacteria;Others
Bacteria_Hyd24-12	Bacteria;Others
Bacteria_Hydrogenedentes	Bacteria;Others
Bacteria_JL-ETNP-Z39	Bacteria;Others
Bacteria_Kazan-3B-09	Bacteria;Others
Bacteria_Latescibacteria_Latescibacteria_Incertae_Sedis_Unknown_Order_Unknown_Family_Candidatus_Latescibacter	Bacteria;Others
Bacteria_LCP-89	Bacteria;Others
Bacteria_LD1-PA38	Bacteria;Others
Bacteria_Lentisphaerae_055B07-P-DI-P58	Bacteria;Others
Bacteria_Lentisphaerae_113B434	Bacteria;Others
Bacteria_Lentisphaerae_B01R017	Bacteria;Others
Bacteria_Lentisphaerae_BS5	Bacteria;Others
Bacteria_Lentisphaerae_c5LKS8	Bacteria;Others
Bacteria_Lentisphaerae_CVer-1_termite_group	Bacteria;Others
Bacteria_Lentisphaerae_CVer-2_termite_group	Bacteria;Others
Bacteria_Lentisphaerae_DEV055	Bacteria;Others
Bacteria_Lentisphaerae_LD1-PA20	Bacteria;Others
Bacteria_Lentisphaerae_LD1-PA26	Bacteria;Others
Bacteria_Lentisphaerae_LD1-PA34	Bacteria;Others
Bacteria_Lentisphaerae_LD1-PB3	Bacteria;Others
Bacteria_Lentisphaerae_Lentisphaerae_RFP12_gut_group	Bacteria;Others
Bacteria_Lentisphaerae_Lentisphaeria_Lentisphaerales_Lentisphaeraceae_Lentisphaera	Bacteria;Others
Bacteria_Lentisphaerae_Lentisphaeria_Victivallales_Victivallaceae_Victivallis	Bacteria;Others
Bacteria_Lentisphaerae_ML1228J-2	Bacteria;Others
Bacteria_Lentisphaerae_ML635J-35	Bacteria;Others
Bacteria_Lentisphaerae_MSBL3	Bacteria;Others
Bacteria_Lentisphaerae_Oligosphaeria_Oligosphaerales_Oligosphaeraceae_Oligosphaera	Bacteria;Others
Bacteria_Lentisphaerae_PBS-III-20	Bacteria;Others
Bacteria_Lentisphaerae_R76-B128	Bacteria;Others
Bacteria_Lentisphaerae_SBYG-2613	Bacteria;Others
Bacteria_Lentisphaerae_SS1-B-03-39	Bacteria;Others
Bacteria_Lentisphaerae_WCHB1-25	Bacteria;Others
Bacteria_Lentisphaerae_WCHB1-41	Bacteria;Others
Bacteria_Marinimicrobia__SAR406_clade_	Bacteria;Others
Bacteria_Microgenomates	Bacteria;Others
Bacteria_Nitrospirae_Nitrospira_Nitrospirales_0319-6A21	Bacteria;Others
Bacteria_Nitrospirae_Nitrospira_Nitrospirales_4-29	Bacteria;Others
Bacteria_Nitrospirae_Nitrospira_Nitrospirales_BT44	Bacteria;Others
Bacteria_Nitrospirae_Nitrospira_Nitrospirales_FTL22	Bacteria;Others
Bacteria_Nitrospirae_Nitrospira_Nitrospirales_MIZ14	Bacteria;Others
Bacteria_Nitrospirae_Nitrospira_Nitrospirales_MIZ17	Bacteria;Others
Bacteria_Nitrospirae_Nitrospira_Nitrospirales_Nitrospiraceae_Candidatus_Magnetobacterium	Bacteria;Others
Bacteria_Nitrospirae_Nitrospira_Nitrospirales_Nitrospiraceae_Candidatus_Magnetoovum	Bacteria;Others
Bacteria_Nitrospirae_Nitrospira_Nitrospirales_Nitrospiraceae_Leptospirillum	Bacteria;Others
Bacteria_Nitrospirae_Nitrospira_Nitrospirales_Nitrospiraceae_Nitrospira	Bacteria;Others
Bacteria_Nitrospirae_Nitrospira_Nitrospirales_Nitrospiraceae_Thermodesulfovibrio	Bacteria;Others
Bacteria_Nitrospirae_Nitrospira_Nitrospirales_Nitrospiraceae_uncultured	Bacteria;Others
Bacteria_Nitrospirae_Nitrospira_Nitrospirales_Nitrospirales_Incertae_Sedis_Candidatus_Methylomirabilis	Bacteria;Others
Bacteria_Nitrospirae_Nitrospira_Nitrospirales_Sh765B-TzT-35	Bacteria;Others
Bacteria_Nitrospirae_Nitrospira_Nitrospirales_wb1-A12	Bacteria;Others
Bacteria_OC31	Bacteria;Others
Bacteria_Omnitrophica_NPL-UPA2	Bacteria;Others
Bacteria_Omnitrophica_Omnitrophica_Incertae_Sedis_Unknown_Order_Unknown_Family_Candidatus_Omnitrophus	Bacteria;Others
Bacteria_Parcubacteria_Parcubacteria_Incertae_Sedis_Unknown_Order_Unknown_Family_Candidatus_Paceibacter	Bacteria;Others
Bacteria_PAUC34f	Bacteria;Others
Bacteria_Planctomycetes_028H05-P-BN-P5	Bacteria;Others
Bacteria_Planctomycetes_BD7-11	Bacteria;Others
Bacteria_Planctomycetes_C47	Bacteria;Others
Bacteria_Planctomycetes_MBMPE71	Bacteria;Others
Bacteria_Planctomycetes_MD2896-B258	Bacteria;Others
Bacteria_Planctomycetes_OM190	Bacteria;Others
Bacteria_Planctomycetes_Phycisphaerae_062DZ93_hypersaline_microbial_mat_group	Bacteria;Others
Bacteria_Planctomycetes_Phycisphaerae_Amsterdam-1B-07	Bacteria;Others
Bacteria_Planctomycetes_Phycisphaerae_B103G10	Bacteria;Others
Bacteria_Planctomycetes_Phycisphaerae_C86	Bacteria;Others
Bacteria_Planctomycetes_Phycisphaerae_CCM11a	Bacteria;Others
Bacteria_Planctomycetes_Phycisphaerae_CPla-3_termite_group	Bacteria;Others
Bacteria_Planctomycetes_Phycisphaerae_KCLunmb-38-53	Bacteria;Others
Bacteria_Planctomycetes_Phycisphaerae_ML-A-10	Bacteria;Others
Bacteria_Planctomycetes_Phycisphaerae_mle1-8	Bacteria;Others
Bacteria_Planctomycetes_Phycisphaerae_MSB-3A7_sediment_group	Bacteria;Others
Bacteria_Planctomycetes_Phycisphaerae_MSBL9	Bacteria;Others
Bacteria_Planctomycetes_Phycisphaerae_ODP1230B30.09	Bacteria;Others
Bacteria_Planctomycetes_Phycisphaerae_Phycisphaerales_08D2Z94_hypersaline_microbial_mat_group	Bacteria;Others
Bacteria_Planctomycetes_Phycisphaerae_Phycisphaerales_AKAU3564_sediment_group	Bacteria;Others
Bacteria_Planctomycetes_Phycisphaerae_Phycisphaerales_ODP1230B30.02_sediment_group	Bacteria;Others
Bacteria_Planctomycetes_Phycisphaerae_Phycisphaerales_Phycisphaeraceae_AKYG587	Bacteria;Others
Bacteria_Planctomycetes_Phycisphaerae_Phycisphaerales_Phycisphaeraceae_Algisphaera	Bacteria;Others
Bacteria_Planctomycetes_Phycisphaerae_Phycisphaerales_Phycisphaeraceae_CL500-3	Bacteria;Others
Bacteria_Planctomycetes_Phycisphaerae_Phycisphaerales_Phycisphaeraceae_FS140-16B-02_marine_group	Bacteria;Others
Bacteria_Planctomycetes_Phycisphaerae_Phycisphaerales_Phycisphaeraceae_I-8	Bacteria;Others
Bacteria_Planctomycetes_Phycisphaerae_Phycisphaerales_Phycisphaeraceae_JL-ETNP-F27	Bacteria;Others
Bacteria_Planctomycetes_Phycisphaerae_Phycisphaerales_Phycisphaeraceae_Phycisphaera	Bacteria;Others
Bacteria_Planctomycetes_Phycisphaerae_Phycisphaerales_Phycisphaeraceae_SM1A02	Bacteria;Others
Bacteria_Planctomycetes_Phycisphaerae_Phycisphaerales_Phycisphaeraceae_uncultured	Bacteria;Others
Bacteria_Planctomycetes_Phycisphaerae_Phycisphaerales_Phycisphaeraceae_Urania-1B-19_marine_sediment_group	Bacteria;Others
Bacteria_Planctomycetes_Phycisphaerae_Phycisphaerales_Phycisphaeraceae_Z195MB87	Bacteria;Others
Bacteria_Planctomycetes_Phycisphaerae_Phycisphaerales_SBYZ-1154	Bacteria;Others
Bacteria_Planctomycetes_Phycisphaerae_Phycisphaerales_SBYZ-984	Bacteria;Others
Bacteria_Planctomycetes_Phycisphaerae_Phycisphaerales_Sva0503	Bacteria;Others
Bacteria_Planctomycetes_Phycisphaerae_Pla1_lineage	Bacteria;Others
Bacteria_Planctomycetes_Phycisphaerae_S-70	Bacteria;Others
Bacteria_Planctomycetes_Phycisphaerae_S15A-MN16	Bacteria;Others
Bacteria_Planctomycetes_Phycisphaerae_SHA-43	Bacteria;Others
Bacteria_Planctomycetes_Phycisphaerae_WD2101_soil_group	Bacteria;Others
Bacteria_Planctomycetes_Pla3_lineage	Bacteria;Others
Bacteria_Planctomycetes_Pla4_lineage	Bacteria;Others
Bacteria_Planctomycetes_Planctomycetacia_Brocadiales_Brocadiaceae	Bacteria;Others
Bacteria_Planctomycetes_Planctomycetacia_Planctomycetales_Planctomycetaceae_Blastopirellula	Bacteria;Others
Bacteria_Planctomycetes_Planctomycetacia_Planctomycetales_Planctomycetaceae_Bythopirellula	Bacteria;Others
Bacteria_Planctomycetes_Planctomycetacia_Planctomycetales_Planctomycetaceae_Candidatus_Anammoximicrobium	Bacteria;Others
Bacteria_Planctomycetes_Planctomycetacia_Planctomycetales_Planctomycetaceae_Candidatus_Nostocoida	Bacteria;Others
Bacteria_Planctomycetes_Planctomycetacia_Planctomycetales_Planctomycetaceae_CPla-4_termite_group	Bacteria;Others
Bacteria_Planctomycetes_Planctomycetacia_Planctomycetales_Planctomycetaceae_Gemmata	Bacteria;Others
Bacteria_Planctomycetes_Planctomycetacia_Planctomycetales_Planctomycetaceae_Isosphaera	Bacteria;Others
Bacteria_Planctomycetes_Planctomycetacia_Planctomycetales_Planctomycetaceae_p-1088-a5_gut_group	Bacteria;Others
Bacteria_Planctomycetes_Planctomycetacia_Planctomycetales_Planctomycetaceae_Pir1_lineage	Bacteria;Others
Bacteria_Planctomycetes_Planctomycetacia_Planctomycetales_Planctomycetaceae_Pir2_lineage	Bacteria;Others
Bacteria_Planctomycetes_Planctomycetacia_Planctomycetales_Planctomycetaceae_Pir3_lineage	Bacteria;Others
Bacteria_Planctomycetes_Planctomycetacia_Planctomycetales_Planctomycetaceae_Pir4_lineage	Bacteria;Others
Bacteria_Planctomycetes_Planctomycetacia_Planctomycetales_Planctomycetaceae_Pirellula	Bacteria;Others
Bacteria_Planctomycetes_Planctomycetacia_Planctomycetales_Planctomycetaceae_Planctomyces	Bacteria;Others
Bacteria_Planctomycetes_Planctomycetacia_Planctomycetales_Planctomycetaceae_Planctopirus	Bacteria;Others
Bacteria_Planctomycetes_Planctomycetacia_Planctomycetales_Planctomycetaceae_Rhodopirellula	Bacteria;Others
Bacteria_Planctomycetes_Planctomycetacia_Planctomycetales_Planctomycetaceae_Roseimaritima	Bacteria;Others
Bacteria_Planctomycetes_Planctomycetacia_Planctomycetales_Planctomycetaceae_Rubripirellula	Bacteria;Others
Bacteria_Planctomycetes_Planctomycetacia_Planctomycetales_Planctomycetaceae_Schlesneria	Bacteria;Others
Bacteria_Planctomycetes_Planctomycetacia_Planctomycetales_Planctomycetaceae_Singulisphaera	Bacteria;Others
Bacteria_Planctomycetes_Planctomycetacia_Planctomycetales_Planctomycetaceae_Telmatocola	Bacteria;Others
Bacteria_Planctomycetes_Planctomycetacia_Planctomycetales_Planctomycetaceae_Termite_planctomycete_cluster	Bacteria;Others
Bacteria_Planctomycetes_Planctomycetacia_Planctomycetales_Planctomycetaceae_uncultured	Bacteria;Others
Bacteria_Planctomycetes_Planctomycetacia_Planctomycetales_Planctomycetaceae_Zavarzinella	Bacteria;Others
Bacteria_Planctomycetes_SGST604	Bacteria;Others
Bacteria_Planctomycetes_SPG12-401-411-B72	Bacteria;Others
Bacteria_Planctomycetes_vadinHA49	Bacteria;Others
Bacteria_Proteobacteria_AEGEAN-245	Bacteria;Proteobacteria
Bacteria_Proteobacteria_Alphaproteobacteria_4-Org1-14	Bacteria;Proteobacteria
Bacteria_Proteobacteria_Alphaproteobacteria_Alphaproteobacteria_Incertae_Sedis_Unknown_Family_Eilatimonas	Bacteria;Proteobacteria
Bacteria_Proteobacteria_Alphaproteobacteria_BF195	Bacteria;Proteobacteria
Bacteria_Proteobacteria_Alphaproteobacteria_Caulobacterales	Bacteria;Proteobacteria
Bacteria_Proteobacteria_Alphaproteobacteria_DB1-14	Bacteria;Proteobacteria
Bacteria_Proteobacteria_Alphaproteobacteria_Dstr-E11	Bacteria;Proteobacteria
Bacteria_Proteobacteria_Alphaproteobacteria_E6aD10	Bacteria;Proteobacteria
Bacteria_Proteobacteria_Alphaproteobacteria_iodide-oxidizers	Bacteria;Proteobacteria
Bacteria_Proteobacteria_Alphaproteobacteria_Kordiimonadales	Bacteria;Proteobacteria
Bacteria_Proteobacteria_Alphaproteobacteria_Magnetococcales_Magnetococcaceae_Magnetococcus	Bacteria;Proteobacteria
Bacteria_Proteobacteria_Alphaproteobacteria_OCS116_clade_Unknown_Family_Candidatus_Phaeomarinobacter	Bacteria;Proteobacteria
Bacteria_Proteobacteria_Alphaproteobacteria_Parvularculales_Parvularculaceae	Bacteria;Proteobacteria
Bacteria_Proteobacteria_Alphaproteobacteria_Rhizobiales	Bacteria;Proteobacteria
Bacteria_Proteobacteria_Alphaproteobacteria_Rhodobacterales_Rhodobacteraceae	Bacteria;Proteobacteria
Bacteria_Proteobacteria_Alphaproteobacteria_Rhodospirillales_Acetobacteraceae	Bacteria;Proteobacteria
Bacteria_Proteobacteria_Alphaproteobacteria_Rhodospirillales_AKYH478	Bacteria;Proteobacteria
Bacteria_Proteobacteria_Alphaproteobacteria_Rhodospirillales_AT-s3-44	Bacteria;Proteobacteria
Bacteria_Proteobacteria_Alphaproteobacteria_Rhodospirillales_B-48	Bacteria;Proteobacteria
Bacteria_Proteobacteria_Alphaproteobacteria_Rhodospirillales_B79	Bacteria;Proteobacteria
Bacteria_Proteobacteria_Alphaproteobacteria_Rhodospirillales_CCU22	Bacteria;Proteobacteria
Bacteria_Proteobacteria_Alphaproteobacteria_Rhodospirillales_DA111	Bacteria;Proteobacteria
Bacteria_Proteobacteria_Alphaproteobacteria_Rhodospirillales_I-10	Bacteria;Proteobacteria
Bacteria_Proteobacteria_Alphaproteobacteria_Rhodospirillales_JG37-AG-20	Bacteria;Proteobacteria
Bacteria_Proteobacteria_Alphaproteobacteria_Rhodospirillales_KCM-B-15	Bacteria;Proteobacteria
Bacteria_Proteobacteria_Alphaproteobacteria_Rhodospirillales_KCM-B-60	Bacteria;Proteobacteria
Bacteria_Proteobacteria_Alphaproteobacteria_Rhodospirillales_ML80	Bacteria;Proteobacteria
Bacteria_Proteobacteria_Alphaproteobacteria_Rhodospirillales_MNC12	Bacteria;Proteobacteria
Bacteria_Proteobacteria_Alphaproteobacteria_Rhodospirillales_MND8	Bacteria;Proteobacteria
Bacteria_Proteobacteria_Alphaproteobacteria_Rhodospirillales_MSB-1E8	Bacteria;Proteobacteria
Bacteria_Proteobacteria_Alphaproteobacteria_Rhodospirillales_Rhodospirillaceae_AEGEAN-169_marine_group	Bacteria;Proteobacteria
Bacteria_Proteobacteria_Alphaproteobacteria_Rhodospirillales_Rhodospirillaceae_Azospirillum	Bacteria;Proteobacteria
Bacteria_Proteobacteria_Alphaproteobacteria_Rhodospirillales_Rhodospirillaceae_Caenispirillum	Bacteria;Proteobacteria
Bacteria_Proteobacteria_Alphaproteobacteria_Rhodospirillales_Rhodospirillaceae_Candidatus_Endolissoclinum	Bacteria;Proteobacteria
Bacteria_Proteobacteria_Alphaproteobacteria_Rhodospirillales_Rhodospirillaceae_Candidatus_Riegeria	Bacteria;Proteobacteria
Bacteria_Proteobacteria_Alphaproteobacteria_Rhodospirillales_Rhodospirillaceae_Defluviicoccus	Bacteria;Proteobacteria
Bacteria_Proteobacteria_Alphaproteobacteria_Rhodospirillales_Rhodospirillaceae_Desertibacter	Bacteria;Proteobacteria
Bacteria_Proteobacteria_Alphaproteobacteria_Rhodospirillales_Rhodospirillaceae_Dongia	Bacteria;Proteobacteria
Bacteria_Proteobacteria_Alphaproteobacteria_Rhodospirillales_Rhodospirillaceae_Elstera	Bacteria;Proteobacteria
Bacteria_Proteobacteria_Alphaproteobacteria_Rhodospirillales_Rhodospirillaceae_Ferrovibrio	Bacteria;Proteobacteria
Bacteria_Proteobacteria_Alphaproteobacteria_Rhodospirillales_Rhodospirillaceae_Fodinicurvata	Bacteria;Proteobacteria
Bacteria_Proteobacteria_Alphaproteobacteria_Rhodospirillales_Rhodospirillaceae_Inquilinus	Bacteria;Proteobacteria
Bacteria_Proteobacteria_Alphaproteobacteria_Rhodospirillales_Rhodospirillaceae_Insolitispirillum	Bacteria;Proteobacteria
Bacteria_Proteobacteria_Alphaproteobacteria_Rhodospirillales_Rhodospirillaceae_Limimonas	Bacteria;Proteobacteria
Bacteria_Proteobacteria_Alphaproteobacteria_Rhodospirillales_Rhodospirillaceae_Magnetospira	Bacteria;Proteobacteria
Bacteria_Proteobacteria_Alphaproteobacteria_Rhodospirillales_Rhodospirillaceae_Magnetospirillum	Bacteria;Proteobacteria
Bacteria_Proteobacteria_Alphaproteobacteria_Rhodospirillales_Rhodospirillaceae_Magnetovibrio	Bacteria;Proteobacteria
Bacteria_Proteobacteria_Alphaproteobacteria_Rhodospirillales_Rhodospirillaceae_Marispirillum	Bacteria;Proteobacteria
Bacteria_Proteobacteria_Alphaproteobacteria_Rhodospirillales_Rhodospirillaceae_Nisaea	Bacteria;Proteobacteria
Bacteria_Proteobacteria_Alphaproteobacteria_Rhodospirillales_Rhodospirillaceae_Novispirillum	Bacteria;Proteobacteria
Bacteria_Proteobacteria_Alphaproteobacteria_Rhodospirillales_Rhodospirillaceae_Oceanibaculum	Bacteria;Proteobacteria
Bacteria_Proteobacteria_Alphaproteobacteria_Rhodospirillales_Rhodospirillaceae_OM75_clade	Bacteria;Proteobacteria
Bacteria_Proteobacteria_Alphaproteobacteria_Rhodospirillales_Rhodospirillaceae_Pararhodospirillum	Bacteria;Proteobacteria
Bacteria_Proteobacteria_Alphaproteobacteria_Rhodospirillales_Rhodospirillaceae_Pelagibius	Bacteria;Proteobacteria
Bacteria_Proteobacteria_Alphaproteobacteria_Rhodospirillales_Rhodospirillaceae_Phaeospirillum	Bacteria;Proteobacteria
Bacteria_Proteobacteria_Alphaproteobacteria_Rhodospirillales_Rhodospirillaceae_Phaeovibrio	Bacteria;Proteobacteria
Bacteria_Proteobacteria_Alphaproteobacteria_Rhodospirillales_Rhodospirillaceae_Rhodocista	Bacteria;Proteobacteria
Bacteria_Proteobacteria_Alphaproteobacteria_Rhodospirillales_Rhodospirillaceae_Rhodospira	Bacteria;Proteobacteria
Bacteria_Proteobacteria_Alphaproteobacteria_Rhodospirillales_Rhodospirillaceae_Rhodospirillum	Bacteria;Proteobacteria
Bacteria_Proteobacteria_Alphaproteobacteria_Rhodospirillales_Rhodospirillaceae_Rhodovibrio	Bacteria;Proteobacteria
Bacteria_Proteobacteria_Alphaproteobacteria_Rhodospirillales_Rhodospirillaceae_Roseospira	Bacteria;Proteobacteria
Bacteria_Proteobacteria_Alphaproteobacteria_Rhodospirillales_Rhodospirillaceae_Roseospirillum	Bacteria;Proteobacteria
Bacteria_Proteobacteria_Alphaproteobacteria_Rhodospirillales_Rhodospirillaceae_Skermanella	Bacteria;Proteobacteria
Bacteria_Proteobacteria_Alphaproteobacteria_Rhodospirillales_Rhodospirillaceae_Telmatospirillum	Bacteria;Proteobacteria
Bacteria_Proteobacteria_Alphaproteobacteria_Rhodospirillales_Rhodospirillaceae_Thalassobaculum	Bacteria;Proteobacteria
Bacteria_Proteobacteria_Alphaproteobacteria_Rhodospirillales_Rhodospirillaceae_Thalassospira	Bacteria;Proteobacteria
Bacteria_Proteobacteria_Alphaproteobacteria_Rhodospirillales_Rhodospirillaceae_Tistlia	Bacteria;Proteobacteria
Bacteria_Proteobacteria_Alphaproteobacteria_Rhodospirillales_Rhodospirillaceae_Tistrella	Bacteria;Proteobacteria
Bacteria_Proteobacteria_Alphaproteobacteria_Rhodospirillales_Rhodospirillaceae_uncultured	Bacteria;Proteobacteria
Bacteria_Proteobacteria_Alphaproteobacteria_Rhodospirillales_Rhodospirillales_Incertae_Sedis	Bacteria;Proteobacteria
Bacteria_Proteobacteria_Alphaproteobacteria_Rickettsiales_AKIW1012	Bacteria;Proteobacteria
Bacteria_Proteobacteria_Alphaproteobacteria_Rickettsiales_Anaplasmataceae	Bacteria;Proteobacteria
Bacteria_Proteobacteria_Alphaproteobacteria_Rickettsiales_bac2nit3	Bacteria;Proteobacteria
Bacteria_Proteobacteria_Alphaproteobacteria_Rickettsiales_EF100-94H03	Bacteria;Proteobacteria
Bacteria_Proteobacteria_Alphaproteobacteria_Rickettsiales_Holosporaceae_Candidatus_Gortzia	Bacteria;Proteobacteria
Bacteria_Proteobacteria_Alphaproteobacteria_Rickettsiales_Holosporaceae_Candidatus_Paraholospora	Bacteria;Proteobacteria
Bacteria_Proteobacteria_Alphaproteobacteria_Rickettsiales_Holosporaceae_Holospora	Bacteria;Proteobacteria
Bacteria_Proteobacteria_Alphaproteobacteria_Rickettsiales_Holosporaceae_uncultured	Bacteria;Proteobacteria
Bacteria_Proteobacteria_Alphaproteobacteria_Rickettsiales_LR_A2-29	Bacteria;Proteobacteria
Bacteria_Proteobacteria_Alphaproteobacteria_Rickettsiales_LWSR-14	Bacteria;Proteobacteria
Bacteria_Proteobacteria_Alphaproteobacteria_Rickettsiales_Mitochondria	Bacteria;Proteobacteria
Bacteria_Proteobacteria_Alphaproteobacteria_Rickettsiales_RB446	Bacteria;Proteobacteria
Bacteria_Proteobacteria_Alphaproteobacteria_Rickettsiales_Rickettsiaceae	Bacteria;Proteobacteria
Bacteria_Proteobacteria_Alphaproteobacteria_Rickettsiales_Rickettsiales_Incertae_Sedis_Candidatus_Anadelfobacter	Bacteria;Proteobacteria
Bacteria_Proteobacteria_Alphaproteobacteria_Rickettsiales_Rickettsiales_Incertae_Sedis_Candidatus_Captivus	Bacteria;Proteobacteria
Bacteria_Proteobacteria_Alphaproteobacteria_Rickettsiales_Rickettsiales_Incertae_Sedis_Candidatus_Cyrtobacter	Bacteria;Proteobacteria
Bacteria_Proteobacteria_Alphaproteobacteria_Rickettsiales_Rickettsiales_Incertae_Sedis_Candidatus_Defluviella	Bacteria;Proteobacteria
Bacteria_Proteobacteria_Alphaproteobacteria_Rickettsiales_Rickettsiales_Incertae_Sedis_Candidatus_Hepatincola	Bacteria;Proteobacteria
Bacteria_Proteobacteria_Alphaproteobacteria_Rickettsiales_Rickettsiales_Incertae_Sedis_Candidatus_Lariskella	Bacteria;Proteobacteria
Bacteria_Proteobacteria_Alphaproteobacteria_Rickettsiales_Rickettsiales_Incertae_Sedis_Candidatus_Midichloria	Bacteria;Proteobacteria
Bacteria_Proteobacteria_Alphaproteobacteria_Rickettsiales_Rickettsiales_Incertae_Sedis_Candidatus_Odyssella	Bacteria;Proteobacteria
Bacteria_Proteobacteria_Alphaproteobacteria_Rickettsiales_Rickettsiales_Incertae_Sedis_Constrictibacter	Bacteria;Proteobacteria
Bacteria_Proteobacteria_Alphaproteobacteria_Rickettsiales_S25-593	Bacteria;Proteobacteria
Bacteria_Proteobacteria_Alphaproteobacteria_Rickettsiales_SAR116_clade_Candidatus_Puniceispirillum	Bacteria;Proteobacteria
Bacteria_Proteobacteria_Alphaproteobacteria_Rickettsiales_SHWN-night2	Bacteria;Proteobacteria
Bacteria_Proteobacteria_Alphaproteobacteria_Rickettsiales_SM1B06	Bacteria;Proteobacteria
Bacteria_Proteobacteria_Alphaproteobacteria_Rickettsiales_SM2D12	Bacteria;Proteobacteria
Bacteria_Proteobacteria_Alphaproteobacteria_Rickettsiales_T9d	Bacteria;Proteobacteria
Bacteria_Proteobacteria_Alphaproteobacteria_Rickettsiales_TK34	Bacteria;Proteobacteria
Bacteria_Proteobacteria_Alphaproteobacteria_Rickettsiales_uncultured	Bacteria;Proteobacteria
Bacteria_Proteobacteria_Alphaproteobacteria_S26-47	Bacteria;Proteobacteria
Bacteria_Proteobacteria_Alphaproteobacteria_SAR11_clade	Bacteria;Proteobacteria
Bacteria_Proteobacteria_Alphaproteobacteria_SB1-18	Bacteria;Proteobacteria
Bacteria_Proteobacteria_Alphaproteobacteria_Sneathiellales_Sneathiellaceae	Bacteria;Proteobacteria
Bacteria_Proteobacteria_Alphaproteobacteria_Sphingomonadales	Bacteria;Proteobacteria
Bacteria_Proteobacteria_Alphaproteobacteria_ss1-B-07-44	Bacteria;Proteobacteria
Bacteria_Proteobacteria_ARKDMS-49	Bacteria;Proteobacteria
Bacteria_Proteobacteria_ARKICE-90	Bacteria;Proteobacteria
Bacteria_Proteobacteria_Betaproteobacteria_070125-BRIC7-5	Bacteria;Proteobacteria
Bacteria_Proteobacteria_Betaproteobacteria_AK4AB2-03B	Bacteria;Proteobacteria
Bacteria_Proteobacteria_Betaproteobacteria_B1-7BS	Bacteria;Proteobacteria
Bacteria_Proteobacteria_Betaproteobacteria_Betaproteobacteria_Incertae_Sedis_Unknown_Family_Chitinivorax	Bacteria;Proteobacteria
Bacteria_Proteobacteria_Betaproteobacteria_Burkholderiales	Bacteria;Proteobacteria
Bacteria_Proteobacteria_Betaproteobacteria_DR-16	Bacteria;Proteobacteria
Bacteria_Proteobacteria_Betaproteobacteria_H2SRC138	Bacteria;Proteobacteria
Bacteria_Proteobacteria_Betaproteobacteria_Hot_Creek_32	Bacteria;Proteobacteria
Bacteria_Proteobacteria_Betaproteobacteria_Hydrogenophilales_Hydrogenophilaceae	Bacteria;Proteobacteria
Bacteria_Proteobacteria_Betaproteobacteria_Methylophilales_Methylophilaceae	Bacteria;Proteobacteria
Bacteria_Proteobacteria_Betaproteobacteria_Neisseriales_Neisseriaceae	Bacteria;Proteobacteria
Bacteria_Proteobacteria_Betaproteobacteria_Nitrosomonadales	Bacteria;Proteobacteria
Bacteria_Proteobacteria_Betaproteobacteria_oca12	Bacteria;Proteobacteria
Bacteria_Proteobacteria_Betaproteobacteria_Procabacteriales_Procabacteriaceae_Procabacter	Bacteria;Proteobacteria
Bacteria_Proteobacteria_Betaproteobacteria_Rhodocyclales_Rhodocyclaceae	Bacteria;Proteobacteria
Bacteria_Proteobacteria_Betaproteobacteria_SC-I-84	Bacteria;Proteobacteria
Bacteria_Proteobacteria_Betaproteobacteria_sl1313	Bacteria;Proteobacteria
Bacteria_Proteobacteria_Betaproteobacteria_TRA3-20	Bacteria;Proteobacteria
Bacteria_Proteobacteria_Betaproteobacteria_UCT_N117	Bacteria;Proteobacteria
Bacteria_Proteobacteria_Betaproteobacteria_Z-21	Bacteria;Proteobacteria
Bacteria_Proteobacteria_BJGMM-U27	Bacteria;Proteobacteria
Bacteria_Proteobacteria_Deltaproteobacteria_10bav-F6	Bacteria;Proteobacteria
Bacteria_Proteobacteria_Deltaproteobacteria_43F-1404R	Bacteria;Proteobacteria
Bacteria_Proteobacteria_Deltaproteobacteria_Apal-E12	Bacteria;Proteobacteria
Bacteria_Proteobacteria_Deltaproteobacteria_Bdellovibrionales_Bacteriovoracaceae_Bacteriovorax	Bacteria;Proteobacteria
Bacteria_Proteobacteria_Deltaproteobacteria_Bdellovibrionales_Bacteriovoracaceae_Deferrisoma	Bacteria;Proteobacteria
Bacteria_Proteobacteria_Deltaproteobacteria_Bdellovibrionales_Bacteriovoracaceae_Halobacteriovorax	Bacteria;Proteobacteria
Bacteria_Proteobacteria_Deltaproteobacteria_Bdellovibrionales_Bacteriovoracaceae_HotSeep-1	Bacteria;Proteobacteria
Bacteria_Proteobacteria_Deltaproteobacteria_Bdellovibrionales_Bacteriovoracaceae_Peredibacter	Bacteria;Proteobacteria
Bacteria_Proteobacteria_Deltaproteobacteria_Bdellovibrionales_Bacteriovoracaceae_uncultured	Bacteria;Proteobacteria
Bacteria_Proteobacteria_Deltaproteobacteria_Bdellovibrionales_Bdellovibrionaceae_Bdellovibrio	Bacteria;Proteobacteria
Bacteria_Proteobacteria_Deltaproteobacteria_Bdellovibrionales_Bdellovibrionaceae_OM27_clade	Bacteria;Proteobacteria
Bacteria_Proteobacteria_Deltaproteobacteria_Deltaproteobacteria_Incertae_Sedis_Syntrophorhabdaceae_Syntrophorhabdus	Bacteria;Proteobacteria
Bacteria_Proteobacteria_Deltaproteobacteria_Desulfarculales_Desulfarculaceae_Desulfarculus	Bacteria;Proteobacteria
Bacteria_Proteobacteria_Deltaproteobacteria_Desulfarculales_Desulfarculaceae_Desulfatiglans	Bacteria;Proteobacteria
Bacteria_Proteobacteria_Deltaproteobacteria_Desulfarculales_Desulfarculaceae_uncultured	Bacteria;Proteobacteria
Bacteria_Proteobacteria_Deltaproteobacteria_Desulfobacterales_Desulfobacteraceae_Algorimarina	Bacteria;Proteobacteria
Bacteria_Proteobacteria_Deltaproteobacteria_Desulfobacterales_Desulfobacteraceae_Candidatus_Desulfamplus	Bacteria;Proteobacteria
Bacteria_Proteobacteria_Deltaproteobacteria_Desulfobacterales_Desulfobacteraceae_Candidatus_Magnetananas	Bacteria;Proteobacteria
Bacteria_Proteobacteria_Deltaproteobacteria_Desulfobacterales_Desulfobacteraceae_Candidatus_Magnetoglobus	Bacteria;Proteobacteria
Bacteria_Proteobacteria_Deltaproteobacteria_Desulfobacterales_Desulfobacteraceae_Candidatus_Magnetomorum	Bacteria;Proteobacteria
Bacteria_Proteobacteria_Deltaproteobacteria_Desulfobacterales_Desulfobacteraceae_Desulfatibacillum	Bacteria;Proteobacteria
Bacteria_Proteobacteria_Deltaproteobacteria_Desulfobacterales_Desulfobacteraceae_Desulfatiferula	Bacteria;Proteobacteria
Bacteria_Proteobacteria_Deltaproteobacteria_Desulfobacterales_Desulfobacteraceae_Desulfatirhabdium	Bacteria;Proteobacteria
Bacteria_Proteobacteria_Deltaproteobacteria_Desulfobacterales_Desulfobacteraceae_Desulfatitalea	Bacteria;Proteobacteria
Bacteria_Proteobacteria_Deltaproteobacteria_Desulfobacterales_Desulfobacteraceae_Desulfobacter	Bacteria;Proteobacteria
Bacteria_Proteobacteria_Deltaproteobacteria_Desulfobacterales_Desulfobacteraceae_Desulfobacterium	Bacteria;Proteobacteria
Bacteria_Proteobacteria_Deltaproteobacteria_Desulfobacterales_Desulfobacteraceae_Desulfobacula	Bacteria;Proteobacteria
Bacteria_Proteobacteria_Deltaproteobacteria_Desulfobacterales_Desulfobacteraceae_Desulfobotulus	Bacteria;Proteobacteria
Bacteria_Proteobacteria_Deltaproteobacteria_Desulfobacterales_Desulfobacteraceae_Desulfocella	Bacteria;Proteobacteria
Bacteria_Proteobacteria_Deltaproteobacteria_Desulfobacterales_Desulfobacteraceae_Desulfococcus	Bacteria;Proteobacteria
Bacteria_Proteobacteria_Deltaproteobacteria_Desulfobacterales_Desulfobacteraceae_Desulfofaba	Bacteria;Proteobacteria
Bacteria_Proteobacteria_Deltaproteobacteria_Desulfobacterales_Desulfobacteraceae_Desulfofrigus	Bacteria;Proteobacteria
Bacteria_Proteobacteria_Deltaproteobacteria_Desulfobacterales_Desulfobacteraceae_Desulfoluna	Bacteria;Proteobacteria
Bacteria_Proteobacteria_Deltaproteobacteria_Desulfobacterales_Desulfobacteraceae_Desulfonatronobacter	Bacteria;Proteobacteria
Bacteria_Proteobacteria_Deltaproteobacteria_Desulfobacterales_Desulfobacteraceae_Desulfonema	Bacteria;Proteobacteria
Bacteria_Proteobacteria_Deltaproteobacteria_Desulfobacterales_Desulfobacteraceae_Desulforegula	Bacteria;Proteobacteria
Bacteria_Proteobacteria_Deltaproteobacteria_Desulfobacterales_Desulfobacteraceae_Desulfosalsimonas	Bacteria;Proteobacteria
Bacteria_Proteobacteria_Deltaproteobacteria_Desulfobacterales_Desulfobacteraceae_Desulfosarcina	Bacteria;Proteobacteria
Bacteria_Proteobacteria_Deltaproteobacteria_Desulfobacterales_Desulfobacteraceae_Desulfospira	Bacteria;Proteobacteria
Bacteria_Proteobacteria_Deltaproteobacteria_Desulfobacterales_Desulfobacteraceae_Desulfotignum	Bacteria;Proteobacteria
Bacteria_Proteobacteria_Deltaproteobacteria_Desulfobacterales_Desulfobacteraceae_SEEP-SRB1	Bacteria;Proteobacteria
Bacteria_Proteobacteria_Deltaproteobacteria_Desulfobacterales_Desulfobacteraceae_Sva0081_sediment_group	Bacteria;Proteobacteria
Bacteria_Proteobacteria_Deltaproteobacteria_Desulfobacterales_Desulfobacteraceae_uncultured	Bacteria;Proteobacteria
Bacteria_Proteobacteria_Deltaproteobacteria_Desulfobacterales_Desulfobulbaceae_Desulfobulbus	Bacteria;Proteobacteria
Bacteria_Proteobacteria_Deltaproteobacteria_Desulfobacterales_Desulfobulbaceae_Desulfocapsa	Bacteria;Proteobacteria
Bacteria_Proteobacteria_Deltaproteobacteria_Desulfobacterales_Desulfobulbaceae_Desulfofustis	Bacteria;Proteobacteria
Bacteria_Proteobacteria_Deltaproteobacteria_Desulfobacterales_Desulfobulbaceae_Desulfopila	Bacteria;Proteobacteria
Bacteria_Proteobacteria_Deltaproteobacteria_Desulfobacterales_Desulfobulbaceae_Desulforhopalus	Bacteria;Proteobacteria
Bacteria_Proteobacteria_Deltaproteobacteria_Desulfobacterales_Desulfobulbaceae_Desulfotalea	Bacteria;Proteobacteria
Bacteria_Proteobacteria_Deltaproteobacteria_Desulfobacterales_Desulfobulbaceae_Desulfurivibrio	Bacteria;Proteobacteria
Bacteria_Proteobacteria_Deltaproteobacteria_Desulfobacterales_Desulfobulbaceae_Dissulfuribacter	Bacteria;Proteobacteria
Bacteria_Proteobacteria_Deltaproteobacteria_Desulfobacterales_Desulfobulbaceae_MSBL7	Bacteria;Proteobacteria
Bacteria_Proteobacteria_Deltaproteobacteria_Desulfobacterales_Desulfobulbaceae_SEEP-SRB2	Bacteria;Proteobacteria
Bacteria_Proteobacteria_Deltaproteobacteria_Desulfobacterales_Desulfobulbaceae_SEEP-SRB4	Bacteria;Proteobacteria
Bacteria_Proteobacteria_Deltaproteobacteria_Desulfobacterales_Desulfobulbaceae_uncultured	Bacteria;Proteobacteria
Bacteria_Proteobacteria_Deltaproteobacteria_Desulfobacterales_Nitrospinaceae_Candidatus_Entotheonella	Bacteria;Proteobacteria
Bacteria_Proteobacteria_Deltaproteobacteria_Desulfobacterales_Nitrospinaceae_Nitrospina	Bacteria;Proteobacteria
Bacteria_Proteobacteria_Deltaproteobacteria_Desulfobacterales_Nitrospinaceae_uncultured	Bacteria;Proteobacteria
Bacteria_Proteobacteria_Deltaproteobacteria_Desulfovibrionales_Desulfohalobiaceae_Desulfohalobium	Bacteria;Proteobacteria
Bacteria_Proteobacteria_Deltaproteobacteria_Desulfovibrionales_Desulfohalobiaceae_Desulfonatronospira	Bacteria;Proteobacteria
Bacteria_Proteobacteria_Deltaproteobacteria_Desulfovibrionales_Desulfohalobiaceae_Desulfonatronovibrio	Bacteria;Proteobacteria
Bacteria_Proteobacteria_Deltaproteobacteria_Desulfovibrionales_Desulfohalobiaceae_Desulfonauticus	Bacteria;Proteobacteria
Bacteria_Proteobacteria_Deltaproteobacteria_Desulfovibrionales_Desulfohalobiaceae_Desulfothermus	Bacteria;Proteobacteria
Bacteria_Proteobacteria_Deltaproteobacteria_Desulfovibrionales_Desulfohalobiaceae_Desulfovermiculus	Bacteria;Proteobacteria
Bacteria_Proteobacteria_Deltaproteobacteria_Desulfovibrionales_Desulfohalobiaceae_uncultured	Bacteria;Proteobacteria
Bacteria_Proteobacteria_Deltaproteobacteria_Desulfovibrionales_Desulfomicrobiaceae_Desulfomicrobium	Bacteria;Proteobacteria
Bacteria_Proteobacteria_Deltaproteobacteria_Desulfovibrionales_Desulfonatronaceae_Desulfonatronum	Bacteria;Proteobacteria
Bacteria_Proteobacteria_Deltaproteobacteria_Desulfovibrionales_Desulfovibrionaceae_Bilophila	Bacteria;Proteobacteria
Bacteria_Proteobacteria_Deltaproteobacteria_Desulfovibrionales_Desulfovibrionaceae_Desulfobaculum	Bacteria;Proteobacteria
Bacteria_Proteobacteria_Deltaproteobacteria_Desulfovibrionales_Desulfovibrionaceae_Desulfocurvus	Bacteria;Proteobacteria
Bacteria_Proteobacteria_Deltaproteobacteria_Desulfovibrionales_Desulfovibrionaceae_Desulfovibrio	Bacteria;Proteobacteria
Bacteria_Proteobacteria_Deltaproteobacteria_Desulfovibrionales_Desulfovibrionaceae_Lawsonia	Bacteria;Proteobacteria
Bacteria_Proteobacteria_Deltaproteobacteria_Desulfovibrionales_Desulfovibrionaceae_uncultured	Bacteria;Proteobacteria
Bacteria_Proteobacteria_Deltaproteobacteria_Desulfurellales_Desulfurellaceae_Desulfurella	Bacteria;Proteobacteria
Bacteria_Proteobacteria_Deltaproteobacteria_Desulfurellales_Desulfurellaceae_Hippea	Bacteria;Proteobacteria
Bacteria_Proteobacteria_Deltaproteobacteria_Desulfurellales_Desulfurellaceae_uncultured	Bacteria;Proteobacteria
Bacteria_Proteobacteria_Deltaproteobacteria_Desulfuromonadales_008E09-B-D-P15	Bacteria;Proteobacteria
Bacteria_Proteobacteria_Deltaproteobacteria_Desulfuromonadales_21f08	Bacteria;Proteobacteria
Bacteria_Proteobacteria_Deltaproteobacteria_Desulfuromonadales_AKYG597	Bacteria;Proteobacteria
Bacteria_Proteobacteria_Deltaproteobacteria_Desulfuromonadales_AKYH776	Bacteria;Proteobacteria
Bacteria_Proteobacteria_Deltaproteobacteria_Desulfuromonadales_BVA18	Bacteria;Proteobacteria
Bacteria_Proteobacteria_Deltaproteobacteria_Desulfuromonadales_BVA59	Bacteria;Proteobacteria
Bacteria_Proteobacteria_Deltaproteobacteria_Desulfuromonadales_C8S-102	Bacteria;Proteobacteria
Bacteria_Proteobacteria_Deltaproteobacteria_Desulfuromonadales_Desulfuromonadaceae	Bacteria;Proteobacteria
Bacteria_Proteobacteria_Deltaproteobacteria_Desulfuromonadales_Geobacteraceae	Bacteria;Proteobacteria
Bacteria_Proteobacteria_Deltaproteobacteria_Desulfuromonadales_GR-WP33-58	Bacteria;Proteobacteria
Bacteria_Proteobacteria_Deltaproteobacteria_Desulfuromonadales_HN-HFO16	Bacteria;Proteobacteria
Bacteria_Proteobacteria_Deltaproteobacteria_Desulfuromonadales_JN18-A94-J	Bacteria;Proteobacteria
Bacteria_Proteobacteria_Deltaproteobacteria_Desulfuromonadales_LS4-241	Bacteria;Proteobacteria
Bacteria_Proteobacteria_Deltaproteobacteria_Desulfuromonadales_M113	Bacteria;Proteobacteria
Bacteria_Proteobacteria_Deltaproteobacteria_Desulfuromonadales_M20-Pitesti	Bacteria;Proteobacteria
Bacteria_Proteobacteria_Deltaproteobacteria_Desulfuromonadales_MA-28-I98C	Bacteria;Proteobacteria
Bacteria_Proteobacteria_Deltaproteobacteria_Desulfuromonadales_Sva1033	Bacteria;Proteobacteria
Bacteria_Proteobacteria_Deltaproteobacteria_Desulfuromonadales_uncultured	Bacteria;Proteobacteria
Bacteria_Proteobacteria_Deltaproteobacteria_DTB120	Bacteria;Proteobacteria
Bacteria_Proteobacteria_Deltaproteobacteria_FW113	Bacteria;Proteobacteria
Bacteria_Proteobacteria_Deltaproteobacteria_GR-WP33-30	Bacteria;Proteobacteria
Bacteria_Proteobacteria_Deltaproteobacteria_Myxococcales_27F-1492R	Bacteria;Proteobacteria
Bacteria_Proteobacteria_Deltaproteobacteria_Myxococcales_Amb-16S-1034	Bacteria;Proteobacteria
Bacteria_Proteobacteria_Deltaproteobacteria_Myxococcales_bacteriap25	Bacteria;Proteobacteria
Bacteria_Proteobacteria_Deltaproteobacteria_Myxococcales_BIrii41	Bacteria;Proteobacteria
Bacteria_Proteobacteria_Deltaproteobacteria_Myxococcales_Blfdi19	Bacteria;Proteobacteria
Bacteria_Proteobacteria_Deltaproteobacteria_Myxococcales_Cystobacteraceae	Bacteria;Proteobacteria
Bacteria_Proteobacteria_Deltaproteobacteria_Myxococcales_Eel-36e1D6	Bacteria;Proteobacteria
Bacteria_Proteobacteria_Deltaproteobacteria_Myxococcales_Elev-16S-1158	Bacteria;Proteobacteria
Bacteria_Proteobacteria_Deltaproteobacteria_Myxococcales_FFCH16767	Bacteria;Proteobacteria
Bacteria_Proteobacteria_Deltaproteobacteria_Myxococcales_Haliangiaceae_Haliangium	Bacteria;Proteobacteria
Bacteria_Proteobacteria_Deltaproteobacteria_Myxococcales_KD3-10	Bacteria;Proteobacteria
Bacteria_Proteobacteria_Deltaproteobacteria_Myxococcales_MidBa8	Bacteria;Proteobacteria
Bacteria_Proteobacteria_Deltaproteobacteria_Myxococcales_mle1-27	Bacteria;Proteobacteria
Bacteria_Proteobacteria_Deltaproteobacteria_Myxococcales_MSB-4B10	Bacteria;Proteobacteria
Bacteria_Proteobacteria_Deltaproteobacteria_Myxococcales_Myxococcaceae	Bacteria;Proteobacteria
Bacteria_Proteobacteria_Deltaproteobacteria_Myxococcales_Nannocystaceae	Bacteria;Proteobacteria
Bacteria_Proteobacteria_Deltaproteobacteria_Myxococcales_P3OB-42	Bacteria;Proteobacteria
Bacteria_Proteobacteria_Deltaproteobacteria_Myxococcales_Phaselicystidaceae_Phaselicystis	Bacteria;Proteobacteria
Bacteria_Proteobacteria_Deltaproteobacteria_Myxococcales_Polyangiaceae	Bacteria;Proteobacteria
Bacteria_Proteobacteria_Deltaproteobacteria_Myxococcales_PS-B29	Bacteria;Proteobacteria
Bacteria_Proteobacteria_Deltaproteobacteria_Myxococcales_Sandaracinaceae_Sandaracinus	Bacteria;Proteobacteria
Bacteria_Proteobacteria_Deltaproteobacteria_Myxococcales_Sandaracinaceae_uncultured	Bacteria;Proteobacteria
Bacteria_Proteobacteria_Deltaproteobacteria_Myxococcales_UASB-TL25	Bacteria;Proteobacteria
Bacteria_Proteobacteria_Deltaproteobacteria_Myxococcales_uncultured	Bacteria;Proteobacteria
Bacteria_Proteobacteria_Deltaproteobacteria_Myxococcales_VHS-B3-70	Bacteria;Proteobacteria
Bacteria_Proteobacteria_Deltaproteobacteria_Myxococcales_VHS-B4-70	Bacteria;Proteobacteria
Bacteria_Proteobacteria_Deltaproteobacteria_Myxococcales_Vulgatibacteraceae_Vulgatibacter	Bacteria;Proteobacteria
Bacteria_Proteobacteria_Deltaproteobacteria_Oligoflexales_Oligoflexaceae_Oligoflexus	Bacteria;Proteobacteria
Bacteria_Proteobacteria_Deltaproteobacteria_Rs-K70_termite_group	Bacteria;Proteobacteria
Bacteria_Proteobacteria_Deltaproteobacteria_SAR324_clade_Marine_group_B_	Bacteria;Proteobacteria
Bacteria_Proteobacteria_Deltaproteobacteria_SBYG-4553	Bacteria;Proteobacteria
Bacteria_Proteobacteria_Deltaproteobacteria_Sh765B-TzT-29	Bacteria;Proteobacteria
Bacteria_Proteobacteria_Deltaproteobacteria_Sva0485	Bacteria;Proteobacteria
Bacteria_Proteobacteria_Deltaproteobacteria_Syntrophobacterales_Syntrophaceae_Desulfobacca	Bacteria;Proteobacteria
Bacteria_Proteobacteria_Deltaproteobacteria_Syntrophobacterales_Syntrophaceae_Desulfomonile	Bacteria;Proteobacteria
Bacteria_Proteobacteria_Deltaproteobacteria_Syntrophobacterales_Syntrophaceae_Smithella	Bacteria;Proteobacteria
Bacteria_Proteobacteria_Deltaproteobacteria_Syntrophobacterales_Syntrophaceae_Syntrophus	Bacteria;Proteobacteria
Bacteria_Proteobacteria_Deltaproteobacteria_Syntrophobacterales_Syntrophaceae_uncultured	Bacteria;Proteobacteria
Bacteria_Proteobacteria_Deltaproteobacteria_Syntrophobacterales_Syntrophobacteraceae_Desulfacinum	Bacteria;Proteobacteria
Bacteria_Proteobacteria_Deltaproteobacteria_Syntrophobacterales_Syntrophobacteraceae_Desulfoglaeba	Bacteria;Proteobacteria
Bacteria_Proteobacteria_Deltaproteobacteria_Syntrophobacterales_Syntrophobacteraceae_Desulforhabdus	Bacteria;Proteobacteria
Bacteria_Proteobacteria_Deltaproteobacteria_Syntrophobacterales_Syntrophobacteraceae_Desulfosoma	Bacteria;Proteobacteria
Bacteria_Proteobacteria_Deltaproteobacteria_Syntrophobacterales_Syntrophobacteraceae_Desulfovirga	Bacteria;Proteobacteria
Bacteria_Proteobacteria_Deltaproteobacteria_Syntrophobacterales_Syntrophobacteraceae_Syntrophobacter	Bacteria;Proteobacteria
Bacteria_Proteobacteria_Deltaproteobacteria_Syntrophobacterales_Syntrophobacteraceae_Thermodesulforhabdus	Bacteria;Proteobacteria
Bacteria_Proteobacteria_Deltaproteobacteria_Syntrophobacterales_Syntrophobacteraceae_uncultured	Bacteria;Proteobacteria
Bacteria_Proteobacteria_Elev-16S-509	Bacteria;Proteobacteria
Bacteria_Proteobacteria_Epsilonproteobacteria_BG.g7	Bacteria;Proteobacteria
Bacteria_Proteobacteria_Epsilonproteobacteria_BR36	Bacteria;Proteobacteria
Bacteria_Proteobacteria_Epsilonproteobacteria_Campylobacterales_Campylobacteraceae_Arcobacter	Bacteria;Proteobacteria
Bacteria_Proteobacteria_Epsilonproteobacteria_Campylobacterales_Campylobacteraceae_Campylobacter	Bacteria;Proteobacteria
Bacteria_Proteobacteria_Epsilonproteobacteria_Campylobacterales_Campylobacteraceae_Sulfurospirillum	Bacteria;Proteobacteria
Bacteria_Proteobacteria_Epsilonproteobacteria_Campylobacterales_Campylobacteraceae_Thiofractor	Bacteria;Proteobacteria
Bacteria_Proteobacteria_Epsilonproteobacteria_Campylobacterales_Helicobacteraceae_Helicobacter	Bacteria;Proteobacteria
Bacteria_Proteobacteria_Epsilonproteobacteria_Campylobacterales_Helicobacteraceae_Rs-M59_termite_group	Bacteria;Proteobacteria
Bacteria_Proteobacteria_Epsilonproteobacteria_Campylobacterales_Helicobacteraceae_Sulfuricurvum	Bacteria;Proteobacteria
Bacteria_Proteobacteria_Epsilonproteobacteria_Campylobacterales_Helicobacteraceae_Sulfurimonas	Bacteria;Proteobacteria
Bacteria_Proteobacteria_Epsilonproteobacteria_Campylobacterales_Helicobacteraceae_Sulfurovum	Bacteria;Proteobacteria
Bacteria_Proteobacteria_Epsilonproteobacteria_Campylobacterales_Helicobacteraceae_uncultured	Bacteria;Proteobacteria
Bacteria_Proteobacteria_Epsilonproteobacteria_Campylobacterales_Helicobacteraceae_Wolinella	Bacteria;Proteobacteria
Bacteria_Proteobacteria_Epsilonproteobacteria_Campylobacterales_Hydrogenimonaceae_Hydrogenimonas	Bacteria;Proteobacteria
Bacteria_Proteobacteria_Epsilonproteobacteria_CH8-1-BAC	Bacteria;Proteobacteria
Bacteria_Proteobacteria_Epsilonproteobacteria_Nautiliales_Nautiliaceae_Caminibacter	Bacteria;Proteobacteria
Bacteria_Proteobacteria_Epsilonproteobacteria_Nautiliales_Nautiliaceae_Lebetimonas	Bacteria;Proteobacteria
Bacteria_Proteobacteria_Epsilonproteobacteria_Nautiliales_Nautiliaceae_Nautilia	Bacteria;Proteobacteria
Bacteria_Proteobacteria_Epsilonproteobacteria_Nautiliales_Nautiliaceae_Nitratifractor	Bacteria;Proteobacteria
Bacteria_Proteobacteria_Epsilonproteobacteria_Nautiliales_Nautiliaceae_Nitratiruptor	Bacteria;Proteobacteria
Bacteria_Proteobacteria_Epsilonproteobacteria_Nautiliales_Nautiliaceae_Thioreductor	Bacteria;Proteobacteria
Bacteria_Proteobacteria_Epsilonproteobacteria_Nautiliales_Nautiliaceae_uncultured	Bacteria;Proteobacteria
Bacteria_Proteobacteria_Epsilonproteobacteria_P6-b51	Bacteria;Proteobacteria
Bacteria_Proteobacteria_Epsilonproteobacteria_PS-B32	Bacteria;Proteobacteria
Bacteria_Proteobacteria_Epsilonproteobacteria_R103-B63	Bacteria;Proteobacteria
Bacteria_Proteobacteria_Epsilonproteobacteria_TS-13	Bacteria;Proteobacteria
Bacteria_Proteobacteria_Epsilonproteobacteria_VC1.2-cl42	Bacteria;Proteobacteria
Bacteria_Proteobacteria_FGL7S	Bacteria;Proteobacteria
Bacteria_Proteobacteria_Gammaproteobacteria_1013-28-CG33	Bacteria;Proteobacteria
Bacteria_Proteobacteria_Gammaproteobacteria_195up	Bacteria;Proteobacteria
Bacteria_Proteobacteria_Gammaproteobacteria_34P16	Bacteria;Proteobacteria
Bacteria_Proteobacteria_Gammaproteobacteria_aaa34a10	Bacteria;Proteobacteria
Bacteria_Proteobacteria_Gammaproteobacteria_Acidithiobacillales	Bacteria;Proteobacteria
Bacteria_Proteobacteria_Gammaproteobacteria_Aeromonadales	Bacteria;Proteobacteria
Bacteria_Proteobacteria_Gammaproteobacteria_Alteromonadales	Bacteria;Proteobacteria
Bacteria_Proteobacteria_Gammaproteobacteria_Arenicellales_Arenicellaceae	Bacteria;Proteobacteria
Bacteria_Proteobacteria_Gammaproteobacteria_B38	Bacteria;Proteobacteria
Bacteria_Proteobacteria_Gammaproteobacteria_BD3-1	Bacteria;Proteobacteria
Bacteria_Proteobacteria_Gammaproteobacteria_BD7-8_marine_group	Bacteria;Proteobacteria
Bacteria_Proteobacteria_Gammaproteobacteria_BD72BR169	Bacteria;Proteobacteria
Bacteria_Proteobacteria_Gammaproteobacteria_BM1-4-101	Bacteria;Proteobacteria
Bacteria_Proteobacteria_Gammaproteobacteria_Cardiobacteriales_Cardiobacteriaceae	Bacteria;Proteobacteria
Bacteria_Proteobacteria_Gammaproteobacteria_Cellvibrionales	Bacteria;Proteobacteria
Bacteria_Proteobacteria_Gammaproteobacteria_Chromatiales_Chromatiaceae_Allochromatium	Bacteria;Proteobacteria
Bacteria_Proteobacteria_Gammaproteobacteria_Chromatiales_Chromatiaceae_Chromatium	Bacteria;Proteobacteria
Bacteria_Proteobacteria_Gammaproteobacteria_Chromatiales_Chromatiaceae_Halochromatium	Bacteria;Proteobacteria
Bacteria_Proteobacteria_Gammaproteobacteria_Chromatiales_Chromatiaceae_Isochromatium	Bacteria;Proteobacteria
Bacteria_Proteobacteria_Gammaproteobacteria_Chromatiales_Chromatiaceae_Lamprocystis	Bacteria;Proteobacteria
Bacteria_Proteobacteria_Gammaproteobacteria_Chromatiales_Chromatiaceae_Marichromatium	Bacteria;Proteobacteria
Bacteria_Proteobacteria_Gammaproteobacteria_Chromatiales_Chromatiaceae_Nitrosococcus	Bacteria;Proteobacteria
Bacteria_Proteobacteria_Gammaproteobacteria_Chromatiales_Chromatiaceae_Phaeochromatium	Bacteria;Proteobacteria
Bacteria_Proteobacteria_Gammaproteobacteria_Chromatiales_Chromatiaceae_Rhabdochromatium	Bacteria;Proteobacteria
Bacteria_Proteobacteria_Gammaproteobacteria_Chromatiales_Chromatiaceae_Rheinheimera	Bacteria;Proteobacteria
Bacteria_Proteobacteria_Gammaproteobacteria_Chromatiales_Chromatiaceae_Thioalkalicoccus	Bacteria;Proteobacteria
Bacteria_Proteobacteria_Gammaproteobacteria_Chromatiales_Chromatiaceae_Thiobaca	Bacteria;Proteobacteria
Bacteria_Proteobacteria_Gammaproteobacteria_Chromatiales_Chromatiaceae_Thiocapsa	Bacteria;Proteobacteria
Bacteria_Proteobacteria_Gammaproteobacteria_Chromatiales_Chromatiaceae_Thiococcus	Bacteria;Proteobacteria
Bacteria_Proteobacteria_Gammaproteobacteria_Chromatiales_Chromatiaceae_Thiocystis	Bacteria;Proteobacteria
Bacteria_Proteobacteria_Gammaproteobacteria_Chromatiales_Chromatiaceae_Thiodictyon	Bacteria;Proteobacteria
Bacteria_Proteobacteria_Gammaproteobacteria_Chromatiales_Chromatiaceae_Thioflavicoccus	Bacteria;Proteobacteria
Bacteria_Proteobacteria_Gammaproteobacteria_Chromatiales_Chromatiaceae_Thiohalobacter	Bacteria;Proteobacteria
Bacteria_Proteobacteria_Gammaproteobacteria_Chromatiales_Chromatiaceae_Thiohalocapsa	Bacteria;Proteobacteria
Bacteria_Proteobacteria_Gammaproteobacteria_Chromatiales_Chromatiaceae_Thiolamprovum	Bacteria;Proteobacteria
Bacteria_Proteobacteria_Gammaproteobacteria_Chromatiales_Chromatiaceae_Thiophaeococcus	Bacteria;Proteobacteria
Bacteria_Proteobacteria_Gammaproteobacteria_Chromatiales_Chromatiaceae_Thiorhodococcus	Bacteria;Proteobacteria
Bacteria_Proteobacteria_Gammaproteobacteria_Chromatiales_Chromatiaceae_Thiorhodovibrio	Bacteria;Proteobacteria
Bacteria_Proteobacteria_Gammaproteobacteria_Chromatiales_Chromatiaceae_uncultured	Bacteria;Proteobacteria
Bacteria_Proteobacteria_Gammaproteobacteria_Chromatiales_Ectothiorhodospiraceae_Acidiferrobacter	Bacteria;Proteobacteria
Bacteria_Proteobacteria_Gammaproteobacteria_Chromatiales_Ectothiorhodospiraceae_Alkalilimnicola	Bacteria;Proteobacteria
Bacteria_Proteobacteria_Gammaproteobacteria_Chromatiales_Ectothiorhodospiraceae_Alkalispirillum	Bacteria;Proteobacteria
Bacteria_Proteobacteria_Gammaproteobacteria_Chromatiales_Ectothiorhodospiraceae_Aquisalimonas	Bacteria;Proteobacteria
Bacteria_Proteobacteria_Gammaproteobacteria_Chromatiales_Ectothiorhodospiraceae_Arhodomonas	Bacteria;Proteobacteria
Bacteria_Proteobacteria_Gammaproteobacteria_Chromatiales_Ectothiorhodospiraceae_Ectothiorhodosinus	Bacteria;Proteobacteria
Bacteria_Proteobacteria_Gammaproteobacteria_Chromatiales_Ectothiorhodospiraceae_Ectothiorhodospira	Bacteria;Proteobacteria
Bacteria_Proteobacteria_Gammaproteobacteria_Chromatiales_Ectothiorhodospiraceae_Halorhodospira	Bacteria;Proteobacteria
Bacteria_Proteobacteria_Gammaproteobacteria_Chromatiales_Ectothiorhodospiraceae_Natronocella	Bacteria;Proteobacteria
Bacteria_Proteobacteria_Gammaproteobacteria_Chromatiales_Ectothiorhodospiraceae_Nitrococcus	Bacteria;Proteobacteria
Bacteria_Proteobacteria_Gammaproteobacteria_Chromatiales_Ectothiorhodospiraceae_Spiribacter	Bacteria;Proteobacteria
Bacteria_Proteobacteria_Gammaproteobacteria_Chromatiales_Ectothiorhodospiraceae_Thioalkalispira	Bacteria;Proteobacteria
Bacteria_Proteobacteria_Gammaproteobacteria_Chromatiales_Ectothiorhodospiraceae_Thioalkalivibrio	Bacteria;Proteobacteria
Bacteria_Proteobacteria_Gammaproteobacteria_Chromatiales_Ectothiorhodospiraceae_Thiogranum	Bacteria;Proteobacteria
Bacteria_Proteobacteria_Gammaproteobacteria_Chromatiales_Ectothiorhodospiraceae_Thiohalospira	Bacteria;Proteobacteria
Bacteria_Proteobacteria_Gammaproteobacteria_Chromatiales_Ectothiorhodospiraceae_Thiorhodospira	Bacteria;Proteobacteria
Bacteria_Proteobacteria_Gammaproteobacteria_Chromatiales_Ectothiorhodospiraceae_uncultured	Bacteria;Proteobacteria
Bacteria_Proteobacteria_Gammaproteobacteria_Chromatiales_Granulosicoccaceae_Granulosicoccus	Bacteria;Proteobacteria
Bacteria_Proteobacteria_Gammaproteobacteria_Chromatiales_Halothiobacillaceae	Bacteria;Proteobacteria
Bacteria_Proteobacteria_Gammaproteobacteria_CK-1C2-67	Bacteria;Proteobacteria
Bacteria_Proteobacteria_Gammaproteobacteria_CK-1C4-49	Bacteria;Proteobacteria
Bacteria_Proteobacteria_Gammaproteobacteria_CS-B046	Bacteria;Proteobacteria
Bacteria_Proteobacteria_Gammaproteobacteria_DSM_5130	Bacteria;Proteobacteria
Bacteria_Proteobacteria_Gammaproteobacteria_E01-9C-26_marine_group	Bacteria;Proteobacteria
Bacteria_Proteobacteria_Gammaproteobacteria_EC3	Bacteria;Proteobacteria
Bacteria_Proteobacteria_Gammaproteobacteria_Enterobacteriales_Enterobacteriaceae	Bacteria;Proteobacteria
Bacteria_Proteobacteria_Gammaproteobacteria_Gammaproteobacteria_Incertae_Sedis_Unknown_Family	Bacteria;Proteobacteria
Bacteria_Proteobacteria_Gammaproteobacteria_HOC36	Bacteria;Proteobacteria
Bacteria_Proteobacteria_Gammaproteobacteria_JPC-34	Bacteria;Proteobacteria
Bacteria_Proteobacteria_Gammaproteobacteria_KI89A_clade	Bacteria;Proteobacteria
Bacteria_Proteobacteria_Gammaproteobacteria_KM16	Bacteria;Proteobacteria
Bacteria_Proteobacteria_Gammaproteobacteria_Legionellales_Coxiellaceae_Aquicella	Bacteria;Proteobacteria
Bacteria_Proteobacteria_Gammaproteobacteria_Legionellales_Coxiellaceae_Coxiella	Bacteria;Proteobacteria
Bacteria_Proteobacteria_Gammaproteobacteria_Legionellales_Coxiellaceae_Diplorickettsia	Bacteria;Proteobacteria
Bacteria_Proteobacteria_Gammaproteobacteria_Legionellales_Coxiellaceae_Rickettsiella	Bacteria;Proteobacteria
Bacteria_Proteobacteria_Gammaproteobacteria_Legionellales_Coxiellaceae_uncultured	Bacteria;Proteobacteria
Bacteria_Proteobacteria_Gammaproteobacteria_Legionellales_Legionellaceae	Bacteria;Proteobacteria
Bacteria_Proteobacteria_Gammaproteobacteria_MD2904-B13	Bacteria;Proteobacteria
Bacteria_Proteobacteria_Gammaproteobacteria_Methylococcales	Bacteria;Proteobacteria
Bacteria_Proteobacteria_Gammaproteobacteria_NIASMIV	Bacteria;Proteobacteria
Bacteria_Proteobacteria_Gammaproteobacteria_NKB5	Bacteria;Proteobacteria
Bacteria_Proteobacteria_Gammaproteobacteria_Oceanospirillales_2B4	Bacteria;Proteobacteria
Bacteria_Proteobacteria_Gammaproteobacteria_Oceanospirillales_Alcanivoracaceae	Bacteria;Proteobacteria
Bacteria_Proteobacteria_Gammaproteobacteria_Oceanospirillales_BPS-CK174	Bacteria;Proteobacteria
Bacteria_Proteobacteria_Gammaproteobacteria_Oceanospirillales_CrystalBog021C3	Bacteria;Proteobacteria
Bacteria_Proteobacteria_Gammaproteobacteria_Oceanospirillales_E12-CR02-full	Bacteria;Proteobacteria
Bacteria_Proteobacteria_Gammaproteobacteria_Oceanospirillales_G02-CR02-full	Bacteria;Proteobacteria
Bacteria_Proteobacteria_Gammaproteobacteria_Oceanospirillales_GSP65	Bacteria;Proteobacteria
Bacteria_Proteobacteria_Gammaproteobacteria_Oceanospirillales_Hahellaceae	Bacteria;Proteobacteria
Bacteria_Proteobacteria_Gammaproteobacteria_Oceanospirillales_Halomonadaceae	Bacteria;Proteobacteria
Bacteria_Proteobacteria_Gammaproteobacteria_Oceanospirillales_J8P41000-1F04	Bacteria;Proteobacteria
Bacteria_Proteobacteria_Gammaproteobacteria_Oceanospirillales_JL-ETNP-Y6	Bacteria;Proteobacteria
Bacteria_Proteobacteria_Gammaproteobacteria_Oceanospirillales_Litoricolaceae_Litoricola	Bacteria;Proteobacteria
Bacteria_Proteobacteria_Gammaproteobacteria_Oceanospirillales_MBAE14	Bacteria;Proteobacteria
Bacteria_Proteobacteria_Gammaproteobacteria_Oceanospirillales_ME2	Bacteria;Proteobacteria
Bacteria_Proteobacteria_Gammaproteobacteria_Oceanospirillales_ML617.5J-3	Bacteria;Proteobacteria
Bacteria_Proteobacteria_Gammaproteobacteria_Oceanospirillales_Nit5Au0613-695	Bacteria;Proteobacteria
Bacteria_Proteobacteria_Gammaproteobacteria_Oceanospirillales_Oceanospirillaceae_Amphritea	Bacteria;Proteobacteria
Bacteria_Proteobacteria_Gammaproteobacteria_Oceanospirillales_Oceanospirillaceae_Balneatrix	Bacteria;Proteobacteria
Bacteria_Proteobacteria_Gammaproteobacteria_Oceanospirillales_Oceanospirillaceae_Bermanella	Bacteria;Proteobacteria
Bacteria_Proteobacteria_Gammaproteobacteria_Oceanospirillales_Oceanospirillaceae_Corallomonas	Bacteria;Proteobacteria
Bacteria_Proteobacteria_Gammaproteobacteria_Oceanospirillales_Oceanospirillaceae_Litoribacillus	Bacteria;Proteobacteria
Bacteria_Proteobacteria_Gammaproteobacteria_Oceanospirillales_Oceanospirillaceae_Marinobacterium	Bacteria;Proteobacteria
Bacteria_Proteobacteria_Gammaproteobacteria_Oceanospirillales_Oceanospirillaceae_Marinomonas	Bacteria;Proteobacteria
Bacteria_Proteobacteria_Gammaproteobacteria_Oceanospirillales_Oceanospirillaceae_Marinospirillum	Bacteria;Proteobacteria
Bacteria_Proteobacteria_Gammaproteobacteria_Oceanospirillales_Oceanospirillaceae_Neptuniibacter	Bacteria;Proteobacteria
Bacteria_Proteobacteria_Gammaproteobacteria_Oceanospirillales_Oceanospirillaceae_Neptunomonas	Bacteria;Proteobacteria
Bacteria_Proteobacteria_Gammaproteobacteria_Oceanospirillales_Oceanospirillaceae_Nitrincola	Bacteria;Proteobacteria
Bacteria_Proteobacteria_Gammaproteobacteria_Oceanospirillales_Oceanospirillaceae_Oceaniserpentilla	Bacteria;Proteobacteria
Bacteria_Proteobacteria_Gammaproteobacteria_Oceanospirillales_Oceanospirillaceae_Oceanobacter	Bacteria;Proteobacteria
Bacteria_Proteobacteria_Gammaproteobacteria_Oceanospirillales_Oceanospirillaceae_Oceanospirillum	Bacteria;Proteobacteria
Bacteria_Proteobacteria_Gammaproteobacteria_Oceanospirillales_Oceanospirillaceae_Oleibacter	Bacteria;Proteobacteria
Bacteria_Proteobacteria_Gammaproteobacteria_Oceanospirillales_Oceanospirillaceae_Oleispira	Bacteria;Proteobacteria
Bacteria_Proteobacteria_Gammaproteobacteria_Oceanospirillales_Oceanospirillaceae_Pseudospirillum	Bacteria;Proteobacteria
Bacteria_Proteobacteria_Gammaproteobacteria_Oceanospirillales_Oceanospirillaceae_Reinekea	Bacteria;Proteobacteria
Bacteria_Proteobacteria_Gammaproteobacteria_Oceanospirillales_Oceanospirillaceae_Spongiispira	Bacteria;Proteobacteria
Bacteria_Proteobacteria_Gammaproteobacteria_Oceanospirillales_Oceanospirillaceae_Thalassolituus	Bacteria;Proteobacteria
Bacteria_Proteobacteria_Gammaproteobacteria_Oceanospirillales_Oceanospirillaceae_uncultured	Bacteria;Proteobacteria
Bacteria_Proteobacteria_Gammaproteobacteria_Oceanospirillales_Oceanospirillales_Incertae_Sedis	Bacteria;Proteobacteria
Bacteria_Proteobacteria_Gammaproteobacteria_Oceanospirillales_Oleiphilaceae_Oleiphilus	Bacteria;Proteobacteria
Bacteria_Proteobacteria_Gammaproteobacteria_Oceanospirillales_OM182_clade	Bacteria;Proteobacteria
Bacteria_Proteobacteria_Gammaproteobacteria_Oceanospirillales_ORI-860-26	Bacteria;Proteobacteria
Bacteria_Proteobacteria_Gammaproteobacteria_Oceanospirillales_Saccharospirillaceae_Saccharospirillum	Bacteria;Proteobacteria
Bacteria_Proteobacteria_Gammaproteobacteria_Oceanospirillales_SAR86_clade	Bacteria;Proteobacteria
Bacteria_Proteobacteria_Gammaproteobacteria_Oceanospirillales_SGPZ551	Bacteria;Proteobacteria
Bacteria_Proteobacteria_Gammaproteobacteria_Oceanospirillales_SPOTSMAY03-890m3	Bacteria;Proteobacteria
Bacteria_Proteobacteria_Gammaproteobacteria_Oceanospirillales_SS1-B-06-26	Bacteria;Proteobacteria
Bacteria_Proteobacteria_Gammaproteobacteria_Oceanospirillales_SUP05_cluster	Bacteria;Proteobacteria
Bacteria_Proteobacteria_Gammaproteobacteria_Oceanospirillales_TBZ33	Bacteria;Proteobacteria
Bacteria_Proteobacteria_Gammaproteobacteria_Oceanospirillales_uncultured	Bacteria;Proteobacteria
Bacteria_Proteobacteria_Gammaproteobacteria_Oceanospirillales_V1F82b	Bacteria;Proteobacteria
Bacteria_Proteobacteria_Gammaproteobacteria_Oceanospirillales_vesicomya	Bacteria;Proteobacteria
Bacteria_Proteobacteria_Gammaproteobacteria_Oceanospirillales_ZA2525c	Bacteria;Proteobacteria
Bacteria_Proteobacteria_Gammaproteobacteria_Oceanospirillales_ZD0405	Bacteria;Proteobacteria
Bacteria_Proteobacteria_Gammaproteobacteria_Orbales_Orbaceae	Bacteria;Proteobacteria
Bacteria_Proteobacteria_Gammaproteobacteria_Order_Incertae_Sedis_Family_Incertae_Sedis_Marinicella	Bacteria;Proteobacteria
Bacteria_Proteobacteria_Gammaproteobacteria_OXIC-003	Bacteria;Proteobacteria
Bacteria_Proteobacteria_Gammaproteobacteria_Pasteurellales_Pasteurellaceae	Bacteria;Proteobacteria
Bacteria_Proteobacteria_Gammaproteobacteria_Pseudomonadales	Bacteria;Proteobacteria
Bacteria_Proteobacteria_Gammaproteobacteria_PYR10d3	Bacteria;Proteobacteria
Bacteria_Proteobacteria_Gammaproteobacteria_Run-SP154	Bacteria;Proteobacteria
Bacteria_Proteobacteria_Gammaproteobacteria_Salinisphaerales_Salinisphaeraceae_Oceanococcus	Bacteria;Proteobacteria
Bacteria_Proteobacteria_Gammaproteobacteria_Salinisphaerales_Salinisphaeraceae_Salinisphaera	Bacteria;Proteobacteria
Bacteria_Proteobacteria_Gammaproteobacteria_Salinisphaerales_Salinisphaeraceae_uncultured	Bacteria;Proteobacteria
Bacteria_Proteobacteria_Gammaproteobacteria_Salinisphaerales_Salinisphaeraceae_ZD0417_marine_group	Bacteria;Proteobacteria
Bacteria_Proteobacteria_Gammaproteobacteria_SS1-B-09-64	Bacteria;Proteobacteria
Bacteria_Proteobacteria_Gammaproteobacteria_Sva0071	Bacteria;Proteobacteria
Bacteria_Proteobacteria_Gammaproteobacteria_SZB30	Bacteria;Proteobacteria
Bacteria_Proteobacteria_Gammaproteobacteria_TDNP-Wbc97-24-4-116	Bacteria;Proteobacteria
Bacteria_Proteobacteria_Gammaproteobacteria_Thiotrichales_1G93	Bacteria;Proteobacteria
Bacteria_Proteobacteria_Gammaproteobacteria_Thiotrichales_CHAB-XI-27	Bacteria;Proteobacteria
Bacteria_Proteobacteria_Gammaproteobacteria_Thiotrichales_EV818SWSAP88	Bacteria;Proteobacteria
Bacteria_Proteobacteria_Gammaproteobacteria_Thiotrichales_Francisellaceae_Francisella	Bacteria;Proteobacteria
Bacteria_Proteobacteria_Gammaproteobacteria_Thiotrichales_Gven-D09	Bacteria;Proteobacteria
Bacteria_Proteobacteria_Gammaproteobacteria_Thiotrichales_H2-104-2	Bacteria;Proteobacteria
Bacteria_Proteobacteria_Gammaproteobacteria_Thiotrichales_Piscirickettsiaceae_Cycloclasticus	Bacteria;Proteobacteria
Bacteria_Proteobacteria_Gammaproteobacteria_Thiotrichales_Piscirickettsiaceae_endosymbionts	Bacteria;Proteobacteria
Bacteria_Proteobacteria_Gammaproteobacteria_Thiotrichales_Piscirickettsiaceae_Galenea	Bacteria;Proteobacteria
Bacteria_Proteobacteria_Gammaproteobacteria_Thiotrichales_Piscirickettsiaceae_Hydrogenovibrio	Bacteria;Proteobacteria
Bacteria_Proteobacteria_Gammaproteobacteria_Thiotrichales_Piscirickettsiaceae_Marine_Methylotrophic_Group_3	Bacteria;Proteobacteria
Bacteria_Proteobacteria_Gammaproteobacteria_Thiotrichales_Piscirickettsiaceae_Methylophaga	Bacteria;Proteobacteria
Bacteria_Proteobacteria_Gammaproteobacteria_Thiotrichales_Piscirickettsiaceae_Piscirickettsia	Bacteria;Proteobacteria
Bacteria_Proteobacteria_Gammaproteobacteria_Thiotrichales_Piscirickettsiaceae_Sulfurivirga	Bacteria;Proteobacteria
Bacteria_Proteobacteria_Gammaproteobacteria_Thiotrichales_Piscirickettsiaceae_Thioalkalimicrobium	Bacteria;Proteobacteria
Bacteria_Proteobacteria_Gammaproteobacteria_Thiotrichales_Piscirickettsiaceae_Thiomicrospira	Bacteria;Proteobacteria
Bacteria_Proteobacteria_Gammaproteobacteria_Thiotrichales_Piscirickettsiaceae_uncultured	Bacteria;Proteobacteria
Bacteria_Proteobacteria_Gammaproteobacteria_Thiotrichales_Thiotrichaceae_Achromatium	Bacteria;Proteobacteria
Bacteria_Proteobacteria_Gammaproteobacteria_Thiotrichales_Thiotrichaceae_Beggiatoa	Bacteria;Proteobacteria
Bacteria_Proteobacteria_Gammaproteobacteria_Thiotrichales_Thiotrichaceae_Candidatus_Isobeggiatoa	Bacteria;Proteobacteria
Bacteria_Proteobacteria_Gammaproteobacteria_Thiotrichales_Thiotrichaceae_Candidatus_Maribeggiatoa	Bacteria;Proteobacteria
Bacteria_Proteobacteria_Gammaproteobacteria_Thiotrichales_Thiotrichaceae_Candidatus_Marithioploca	Bacteria;Proteobacteria
Bacteria_Proteobacteria_Gammaproteobacteria_Thiotrichales_Thiotrichaceae_Candidatus_Marithrix	Bacteria;Proteobacteria
Bacteria_Proteobacteria_Gammaproteobacteria_Thiotrichales_Thiotrichaceae_Candidatus_Parabeggiatoa	Bacteria;Proteobacteria
Bacteria_Proteobacteria_Gammaproteobacteria_Thiotrichales_Thiotrichaceae_Candidatus_Thiophysa	Bacteria;Proteobacteria
Bacteria_Proteobacteria_Gammaproteobacteria_Thiotrichales_Thiotrichaceae_Candidatus_Thiopilula	Bacteria;Proteobacteria
Bacteria_Proteobacteria_Gammaproteobacteria_Thiotrichales_Thiotrichaceae_Cocleimonas	Bacteria;Proteobacteria
Bacteria_Proteobacteria_Gammaproteobacteria_Thiotrichales_Thiotrichaceae_Leucothrix	Bacteria;Proteobacteria
Bacteria_Proteobacteria_Gammaproteobacteria_Thiotrichales_Thiotrichaceae_Methylohalomonas	Bacteria;Proteobacteria
Bacteria_Proteobacteria_Gammaproteobacteria_Thiotrichales_Thiotrichaceae_Thiomargarita	Bacteria;Proteobacteria
Bacteria_Proteobacteria_Gammaproteobacteria_Thiotrichales_Thiotrichaceae_Thioploca	Bacteria;Proteobacteria
Bacteria_Proteobacteria_Gammaproteobacteria_Thiotrichales_Thiotrichaceae_Thiothrix	Bacteria;Proteobacteria
Bacteria_Proteobacteria_Gammaproteobacteria_Thiotrichales_Thiotrichaceae_uncultured	Bacteria;Proteobacteria
Bacteria_Proteobacteria_Gammaproteobacteria_Thiotrichales_Thiotrichales_Incertae_Sedis_Caedibacter	Bacteria;Proteobacteria
Bacteria_Proteobacteria_Gammaproteobacteria_Thiotrichales_Thiotrichales_Incertae_Sedis_Candidatus_Endoecteinascidia	Bacteria;Proteobacteria
Bacteria_Proteobacteria_Gammaproteobacteria_Thiotrichales_Thiotrichales_Incertae_Sedis_Fangia	Bacteria;Proteobacteria
Bacteria_Proteobacteria_Gammaproteobacteria_Vibrionales_Vibrionaceae	Bacteria;Proteobacteria
Bacteria_Proteobacteria_Gammaproteobacteria_WN-HWB-116	Bacteria;Proteobacteria
Bacteria_Proteobacteria_Gammaproteobacteria_Xanthomonadales_Algiphilaceae_Algiphilus	Bacteria;Proteobacteria
Bacteria_Proteobacteria_Gammaproteobacteria_Xanthomonadales_JTB255_marine_benthic_group	Bacteria;Proteobacteria
Bacteria_Proteobacteria_Gammaproteobacteria_Xanthomonadales_Nevskiaceae	Bacteria;Proteobacteria
Bacteria_Proteobacteria_Gammaproteobacteria_Xanthomonadales_Solimonadaceae	Bacteria;Proteobacteria
Bacteria_Proteobacteria_Gammaproteobacteria_Xanthomonadales_uncultured	Bacteria;Proteobacteria
Bacteria_Proteobacteria_Gammaproteobacteria_Xanthomonadales_Xanthomonadaceae	Bacteria;Proteobacteria
Bacteria_Proteobacteria_Gammaproteobacteria_Xanthomonadales_Xanthomonadales_Incertae_Sedis	Bacteria;Proteobacteria
Bacteria_Proteobacteria_JTB23	Bacteria;Proteobacteria
Bacteria_Proteobacteria_MACA-EFT26	Bacteria;Proteobacteria
Bacteria_Proteobacteria_Milano-WF1B-44	Bacteria;Proteobacteria
Bacteria_Proteobacteria_pItb-vmat-80	Bacteria;Proteobacteria
Bacteria_Proteobacteria_Proteobacteria_Incertae_Sedis_Unknown_Order_Unknown_Family	Bacteria;Proteobacteria
Bacteria_Proteobacteria_SC3-20	Bacteria;Proteobacteria
Bacteria_Proteobacteria_SK259	Bacteria;Proteobacteria
Bacteria_Proteobacteria_Skagenf62	Bacteria;Proteobacteria
Bacteria_Proteobacteria_SPOTSOCT00m83	Bacteria;Proteobacteria
Bacteria_Proteobacteria_TA18	Bacteria;Proteobacteria
Bacteria_Proteobacteria_Zetaproteobacteria_Mariprofundales_Mariprofundaceae_Mariprofundus	Bacteria;Proteobacteria
Bacteria_RsaHF231	Bacteria;Others
Bacteria_S2R-29	Bacteria;Others
Bacteria_Saccharibacteria_Unknown_Class_Unknown_Order_Unknown_Family_Candidatus_Saccharimonas	Bacteria;Others
Bacteria_SBYG-2791	Bacteria;Others
Bacteria_SHA-109	Bacteria;Others
Bacteria_SM2F11	Bacteria;Others
Bacteria_Spirochaetae_Spirochaetes_Spirochaetales_Brachyspiraceae_Brachyspira	Bacteria;Others
Bacteria_Spirochaetae_Spirochaetes_Spirochaetales_Brevinemataceae_Brevinema	Bacteria;Others
Bacteria_Spirochaetae_Spirochaetes_Spirochaetales_Leptospiraceae_Leptonema	Bacteria;Others
Bacteria_Spirochaetae_Spirochaetes_Spirochaetales_Leptospiraceae_Leptospira	Bacteria;Others
Bacteria_Spirochaetae_Spirochaetes_Spirochaetales_Leptospiraceae_Rs-H88_termite_group	Bacteria;Others
Bacteria_Spirochaetae_Spirochaetes_Spirochaetales_Leptospiraceae_Turneriella	Bacteria;Others
Bacteria_Spirochaetae_Spirochaetes_Spirochaetales_Leptospiraceae_uncultured	Bacteria;Others
Bacteria_Spirochaetae_Spirochaetes_Spirochaetales_LH041	Bacteria;Others
Bacteria_Spirochaetae_Spirochaetes_Spirochaetales_PL-11B10	Bacteria;Others
Bacteria_Spirochaetae_Spirochaetes_Spirochaetales_Spirochaetaceae_Borrelia	Bacteria;Others
Bacteria_Spirochaetae_Spirochaetes_Spirochaetales_Spirochaetaceae_M2PT2-76_termite_group	Bacteria;Others
Bacteria_Spirochaetae_Spirochaetes_Spirochaetales_Spirochaetaceae_Salinispira	Bacteria;Others
Bacteria_Spirochaetae_Spirochaetes_Spirochaetales_Spirochaetaceae_Sphaerochaeta	Bacteria;Others
Bacteria_Spirochaetae_Spirochaetes_Spirochaetales_Spirochaetaceae_Spirochaeta_2	Bacteria;Others
Bacteria_Spirochaetae_Spirochaetes_Spirochaetales_Spirochaetaceae_Termite_Treponema_cluster	Bacteria;Others
Bacteria_Spirochaetae_Spirochaetes_Spirochaetales_Spirochaetaceae_Treponema	Bacteria;Others
Bacteria_Spirochaetae_Spirochaetes_Spirochaetales_Spirochaetaceae_Treponema_2	Bacteria;Others
Bacteria_Spirochaetae_Spirochaetes_Spirochaetales_Spirochaetaceae_uncultured	Bacteria;Others
Bacteria_Spirochaetae_Spirochaetes_Spirochaetales_Spirochaetales_Incertae_Sedis_Exilispira	Bacteria;Others
Bacteria_Spirochaetae_Spirochaetes_Spirochaetales_V2072-189E03	Bacteria;Others
Bacteria_Synergistetes_Synergistia_Synergistales_Synergistaceae_Aminiphilus	Bacteria;Others
Bacteria_Synergistetes_Synergistia_Synergistales_Synergistaceae_Aminivibrio	Bacteria;Others
Bacteria_Synergistetes_Synergistia_Synergistales_Synergistaceae_Aminobacterium	Bacteria;Others
Bacteria_Synergistetes_Synergistia_Synergistales_Synergistaceae_Aminomonas	Bacteria;Others
Bacteria_Synergistetes_Synergistia_Synergistales_Synergistaceae_Anaerobaculum	Bacteria;Others
Bacteria_Synergistetes_Synergistia_Synergistales_Synergistaceae_Candidatus_Tammella	Bacteria;Others
Bacteria_Synergistetes_Synergistia_Synergistales_Synergistaceae_Cloacibacillus	Bacteria;Others
Bacteria_Synergistetes_Synergistia_Synergistales_Synergistaceae_Dethiosulfovibrio	Bacteria;Others
Bacteria_Synergistetes_Synergistia_Synergistales_Synergistaceae_Fretibacterium	Bacteria;Others
Bacteria_Synergistetes_Synergistia_Synergistales_Synergistaceae_Jonquetella	Bacteria;Others
Bacteria_Synergistetes_Synergistia_Synergistales_Synergistaceae_Lactivibrio	Bacteria;Others
Bacteria_Synergistetes_Synergistia_Synergistales_Synergistaceae_Pyramidobacter	Bacteria;Others
Bacteria_Synergistetes_Synergistia_Synergistales_Synergistaceae_Synergistes	Bacteria;Others
Bacteria_Synergistetes_Synergistia_Synergistales_Synergistaceae_Thermanaerovibrio	Bacteria;Others
Bacteria_Synergistetes_Synergistia_Synergistales_Synergistaceae_Thermovirga	Bacteria;Others
Bacteria_Synergistetes_Synergistia_Synergistales_Synergistaceae_uncultured	Bacteria;Others
Bacteria_TA06	Bacteria;Others
Bacteria_Tenericutes_Mollicutes_Acholeplasmatales_Acholeplasmataceae_Acholeplasma	Bacteria;Others
Bacteria_Tenericutes_Mollicutes_Anaeroplasmatales_Anaeroplasmataceae_Anaeroplasma	Bacteria;Others
Bacteria_Tenericutes_Mollicutes_DMI	Bacteria;Others
Bacteria_Tenericutes_Mollicutes_EMP-G18	Bacteria;Others
Bacteria_Tenericutes_Mollicutes_Entomoplasmatales	Bacteria;Others
Bacteria_Tenericutes_Mollicutes_EUB33-2	Bacteria;Others
Bacteria_Tenericutes_Mollicutes_Haloplasmatales_Haloplasmataceae_Haloplasma	Bacteria;Others
Bacteria_Tenericutes_Mollicutes_Mollicutes_Incertae_Sedis_Unknown_Family_Candidatus_Phytoplasma	Bacteria;Others
Bacteria_Tenericutes_Mollicutes_Mollicutes_RF9	Bacteria;Others
Bacteria_Tenericutes_Mollicutes_Mycoplasmatales_Mycoplasmataceae_Candidatus_Bacilloplasma	Bacteria;Others
Bacteria_Tenericutes_Mollicutes_Mycoplasmatales_Mycoplasmataceae_Candidatus_Lumbricincola	Bacteria;Others
Bacteria_Tenericutes_Mollicutes_Mycoplasmatales_Mycoplasmataceae_Mycoplasma	Bacteria;Others
Bacteria_Tenericutes_Mollicutes_Mycoplasmatales_Mycoplasmataceae_uncultured	Bacteria;Others
Bacteria_Tenericutes_Mollicutes_Mycoplasmatales_Mycoplasmataceae_Ureaplasma	Bacteria;Others
Bacteria_Tenericutes_Mollicutes_NB1-n	Bacteria;Others
Bacteria_Thermodesulfobacteria_Thermodesulfobacteria_Thermodesulfobacteriales_Thermodesulfobacteriaceae	Bacteria;Others
Bacteria_Thermotogae_Thermotogae_Thermotogales_Thermotogaceae_AUTHM297	Bacteria;Others
Bacteria_Thermotogae_Thermotogae_Thermotogales_Thermotogaceae_Defluviitoga	Bacteria;Others
Bacteria_Thermotogae_Thermotogae_Thermotogales_Thermotogaceae_EM3	Bacteria;Others
Bacteria_Thermotogae_Thermotogae_Thermotogales_Thermotogaceae_Fervidobacterium	Bacteria;Others
Bacteria_Thermotogae_Thermotogae_Thermotogales_Thermotogaceae_GAL15	Bacteria;Others
Bacteria_Thermotogae_Thermotogae_Thermotogales_Thermotogaceae_Geotoga	Bacteria;Others
Bacteria_Thermotogae_Thermotogae_Thermotogales_Thermotogaceae_Kosmotoga	Bacteria;Others
Bacteria_Thermotogae_Thermotogae_Thermotogales_Thermotogaceae_Marinitoga	Bacteria;Others
Bacteria_Thermotogae_Thermotogae_Thermotogales_Thermotogaceae_Mesoaciditoga	Bacteria;Others
Bacteria_Thermotogae_Thermotogae_Thermotogales_Thermotogaceae_Mesotoga	Bacteria;Others
Bacteria_Thermotogae_Thermotogae_Thermotogales_Thermotogaceae_Oceanotoga	Bacteria;Others
Bacteria_Thermotogae_Thermotogae_Thermotogales_Thermotogaceae_Petrotoga	Bacteria;Others
Bacteria_Thermotogae_Thermotogae_Thermotogales_Thermotogaceae_Pseudothermotoga	Bacteria;Others
Bacteria_Thermotogae_Thermotogae_Thermotogales_Thermotogaceae_SC103	Bacteria;Others
Bacteria_Thermotogae_Thermotogae_Thermotogales_Thermotogaceae_Thermosipho	Bacteria;Others
Bacteria_Thermotogae_Thermotogae_Thermotogales_Thermotogaceae_Thermotoga	Bacteria;Others
Bacteria_Thermotogae_Thermotogae_Thermotogales_Thermotogaceae_uncultured	Bacteria;Others
Bacteria_TM6	Bacteria;Others
Bacteria_Verrucomicrobia_Arctic97B-4_marine_group	Bacteria;Others
Bacteria_Verrucomicrobia_B29	Bacteria;Others
Bacteria_Verrucomicrobia_OPB35_soil_group_Unknown_Order_Unknown_Family_Pedosphaera	Bacteria;Others
Bacteria_Verrucomicrobia_Opitutae_101-154	Bacteria;Others
Bacteria_Verrucomicrobia_Opitutae_A714019	Bacteria;Others
Bacteria_Verrucomicrobia_Opitutae_BC-COM435	Bacteria;Others
Bacteria_Verrucomicrobia_Opitutae_DP7-4-61	Bacteria;Others
Bacteria_Verrucomicrobia_Opitutae_MB11C04_marine_group	Bacteria;Others
Bacteria_Verrucomicrobia_Opitutae_Opitutae_vadinHA64	Bacteria;Others
Bacteria_Verrucomicrobia_Opitutae_Opitutales_Opitutaceae	Bacteria;Others
Bacteria_Verrucomicrobia_Opitutae_Puniceicoccales_Puniceicoccaceae_Cerasicoccus	Bacteria;Others
Bacteria_Verrucomicrobia_Opitutae_Puniceicoccales_Puniceicoccaceae_Coraliomargarita	Bacteria;Others
Bacteria_Verrucomicrobia_Opitutae_Puniceicoccales_Puniceicoccaceae_Lentimonas	Bacteria;Others
Bacteria_Verrucomicrobia_Opitutae_Puniceicoccales_Puniceicoccaceae_marine_group	Bacteria;Others
Bacteria_Verrucomicrobia_Opitutae_Puniceicoccales_Puniceicoccaceae_Pelagicoccus	Bacteria;Others
Bacteria_Verrucomicrobia_Opitutae_Puniceicoccales_Puniceicoccaceae_Puniceicoccus	Bacteria;Others
Bacteria_Verrucomicrobia_Opitutae_Puniceicoccales_Puniceicoccaceae_uncultured	Bacteria;Others
Bacteria_Verrucomicrobia_Opitutae_RS-B22	Bacteria;Others
Bacteria_Verrucomicrobia_Opitutae_TV001-27	Bacteria;Others
Bacteria_Verrucomicrobia_S-BQ2-57_soil_group	Bacteria;Others
Bacteria_Verrucomicrobia_Spartobacteria_Chthoniobacterales_01D2Z36	Bacteria;Others
Bacteria_Verrucomicrobia_Spartobacteria_Chthoniobacterales_Chthoniobacteraceae_Chthoniobacter	Bacteria;Others
Bacteria_Verrucomicrobia_Spartobacteria_Chthoniobacterales_DA101_soil_group	Bacteria;Others
Bacteria_Verrucomicrobia_Spartobacteria_Chthoniobacterales_FukuN18_freshwater_group	Bacteria;Others
Bacteria_Verrucomicrobia_Spartobacteria_Chthoniobacterales_LD29	Bacteria;Others
Bacteria_Verrucomicrobia_Spartobacteria_Chthoniobacterales_uncultured	Bacteria;Others
Bacteria_Verrucomicrobia_Spartobacteria_Chthoniobacterales_Xiphinematobacteraceae_Candidatus_Xiphinematobacter	Bacteria;Others
Bacteria_Verrucomicrobia_UA11	Bacteria;Others
Bacteria_Verrucomicrobia_Verrucomicrobia_Incertae_Sedis_Unknown_Order_Unknown_Family_Candidatus_Methylacidiphilum	Bacteria;Others
Bacteria_Verrucomicrobia_Verrucomicrobiae_Verrucomicrobiales_DBS1	Bacteria;Others
Bacteria_Verrucomicrobia_Verrucomicrobiae_Verrucomicrobiales_DEV007	Bacteria;Others
Bacteria_Verrucomicrobia_Verrucomicrobiae_Verrucomicrobiales_P._palm_C_85	Bacteria;Others
Bacteria_Verrucomicrobia_Verrucomicrobiae_Verrucomicrobiales_Rubritaleaceae_Rubritalea	Bacteria;Others
Bacteria_Verrucomicrobia_Verrucomicrobiae_Verrucomicrobiales_Verrucomicrobiaceae_Akkermansia	Bacteria;Others
Bacteria_Verrucomicrobia_Verrucomicrobiae_Verrucomicrobiales_Verrucomicrobiaceae_Brevifollis	Bacteria;Others
Bacteria_Verrucomicrobia_Verrucomicrobiae_Verrucomicrobiales_Verrucomicrobiaceae_Haloferula	Bacteria;Others
Bacteria_Verrucomicrobia_Verrucomicrobiae_Verrucomicrobiales_Verrucomicrobiaceae_Luteolibacter	Bacteria;Others
Bacteria_Verrucomicrobia_Verrucomicrobiae_Verrucomicrobiales_Verrucomicrobiaceae_Persicirhabdus	Bacteria;Others
Bacteria_Verrucomicrobia_Verrucomicrobiae_Verrucomicrobiales_Verrucomicrobiaceae_Prosthecobacter	Bacteria;Others
Bacteria_Verrucomicrobia_Verrucomicrobiae_Verrucomicrobiales_Verrucomicrobiaceae_Roseibacillus	Bacteria;Others
Bacteria_Verrucomicrobia_Verrucomicrobiae_Verrucomicrobiales_Verrucomicrobiaceae_Roseimicrobium	Bacteria;Others
Bacteria_Verrucomicrobia_Verrucomicrobiae_Verrucomicrobiales_Verrucomicrobiaceae_uncultured	Bacteria;Others
Bacteria_Verrucomicrobia_Verrucomicrobiae_Verrucomicrobiales_Verrucomicrobiaceae_Verrucomicrobium	Bacteria;Others
Bacteria_WCHB1-60	Bacteria;Others
Bacteria_WD272	Bacteria;Others
Eukaryota_AB3F14RM1B12	Eukaryota
Eukaryota_Amoebozoa_Archamoebae	Eukaryota
Eukaryota_Amoebozoa_Cavosteliida	Eukaryota
Eukaryota_Amoebozoa_Dictyostelia	Eukaryota
Eukaryota_Amoebozoa_Discosea	Eukaryota
Eukaryota_Amoebozoa_Fractovitelliida_Soliformovum	Eukaryota
Eukaryota_Amoebozoa_Gracilipodida	Eukaryota
Eukaryota_Amoebozoa_LEMD255	Eukaryota
Eukaryota_Amoebozoa_LKM74	Eukaryota
Eukaryota_Amoebozoa_Myxogastria	Eukaryota
Eukaryota_Amoebozoa_Protosporangiida_Protosporangiidae_Protosporangium	Eukaryota
Eukaryota_Amoebozoa_Protosteliida	Eukaryota
Eukaryota_Amoebozoa_Schizoplasmodiida	Eukaryota
Eukaryota_Amoebozoa_Tubulinea	Eukaryota
Eukaryota_Amoebozoa_WIM5	Eukaryota
Eukaryota_Archaeplastida_Chloroplastida	Eukaryota
Eukaryota_Archaeplastida_Glaucophyta	Eukaryota
Eukaryota_Archaeplastida_Rhodophyceae	Eukaryota
Eukaryota_BW-dinoclone28	Eukaryota
Eukaryota_Centrohelida_Acanthocystidae	Eukaryota
Eukaryota_Centrohelida_CV1-B1-93	Eukaryota
Eukaryota_Centrohelida_H1-10	Eukaryota
Eukaryota_Centrohelida_H15-6	Eukaryota
Eukaryota_Centrohelida_H26-1	Eukaryota
Eukaryota_Centrohelida_Heterophryidae	Eukaryota
Eukaryota_Centrohelida_M1-18D08	Eukaryota
Eukaryota_Cryptophyceae_Cryptomonadales	Eukaryota
Eukaryota_Cryptophyceae_Goniomonas	Eukaryota
Eukaryota_Cryptophyceae_Kathablepharidae	Eukaryota
Eukaryota_Cryptophyceae_P1-31	Eukaryota
Eukaryota_D4P07G08	Eukaryota
Eukaryota_DH147-EKD10	Eukaryota
Eukaryota_Excavata_Discoba	Eukaryota
Eukaryota_Excavata_Malawimonas	Eukaryota
Eukaryota_Excavata_Metamonada	Eukaryota
Eukaryota_Haptophyta_Pav3	Eukaryota
Eukaryota_Haptophyta_Pavlovophyceae	Eukaryota
Eukaryota_Haptophyta_Prymnesiophyceae	Eukaryota
Eukaryota_Haptophyta_T58	Eukaryota
Eukaryota_Haptophyta_uncultured	Eukaryota
Eukaryota_Incertae_Sedis_Ancyromonadida	Eukaryota
Eukaryota_Incertae_Sedis_Apusomonadidae	Eukaryota
Eukaryota_Incertae_Sedis_Breviatea	Eukaryota
Eukaryota_Incertae_Sedis_Mantamonas	Eukaryota
Eukaryota_Incertae_Sedis_Palpitomonas	Eukaryota
Eukaryota_Incertae_Sedis_Rigifilida	Eukaryota
Eukaryota_Incertae_Sedis_Telonema	Eukaryota
Eukaryota_NAMAKO-1	Eukaryota
Eukaryota_Opisthokonta_Freshwater_Opisthokonta	Eukaryota
Eukaryota_Opisthokonta_Holozoa	Eukaryota
Eukaryota_Opisthokonta_Nucletmycea	Eukaryota
Eukaryota_Opisthokonta_uncultured	Eukaryota
Eukaryota_Picozoa_Picomonadida_Picomonadidae_Picomonas	Eukaryota
Eukaryota_RT5iin25	Eukaryota
Eukaryota_SA1-3C06	Eukaryota
Eukaryota_SAR_Alveolata	Eukaryota
Eukaryota_SAR_Rhizaria	Eukaryota
Eukaryota_SAR_Stramenopiles	Eukaryota
